a	A
a'	ALEPH
a'2?	HI×NUN
a'3	E2
a'a3	LAGAB×A
a'u'u	A.PA.GISAL.PAD.SI.A
a-gar5	A.LU3
a-ra2	A.DU
a10?	ŠA6
a11?	AN
a12	UD
a12-ra2-bu	UD.DU.BU
a13	UD×U+U+U
a14	E2
a2	A2
a3	PI
a4	A.AN
a5	AK
a6	U
a7	HA
a8	UR
a9	LAGAB×A
ab	AB
ab2	AB2
ab3	AD
ab4	AB@g
aba	AB
aba3	AD
aba4	AB@g
abba	AB
abba2	AB×AŠ2
abbar	LAGAB×A
abbarax(|LAGAB×A|)	LAGAB×A
abbarx(|LAGAB×GAR|)	LAGAB×GAR
abbununna	UD.HU.HI.NUN
abbununnax(|UD.HU.HI.NUN.NA|)	UD.HU.HI.NUN.NA
abbununnu	UD.HU.HI.NUN
abbununnux(|UD.HU.HI.NUN.NA|)	UD.HU.HI.NUN.NA
abgal	NUN.ME
abgal2	NUN.ME.KA×GAN2@t
abgalx(|NUN.ME.KA×ME|)	NUN.ME.KA×ME
ablal	LAGAB×A+LAL
ablal2?	LAGAB×A
ablal3	LAGAB×U+A
ablalx(|LAGAB×KIN|)	LAGAB×KIN
abni2	KI.NE
abnu	UD.NI
abrig	NUN.ME.DU
abrig2	AB2.NUN.ME.DU
absin	KI.AŠ.AŠ
absin2	AB.NAM
absin3	APIN
absu	ZU.AB
abul	KA2.GAL
abula	KA2.GAL
abulla	KA2.GAL
abx(NUN)	NUN
abx(|AN.AN|)	AN.AN
abzu	ZU.AB
abzux(|UMUM×KASKAL|)	UMUM×KASKAL
abšin3	APIN
ad	AD
ad-kid	AD.KID
ad-kidx(|AD.E2|)	AD.E2
ad2	GIR2@g
ad3	LU×BAD
ad4	ZA@t
ad5	U2.GIR2@g
ad6	LU2×BAD
ada	AD
adab	UD.NUN
adaba	UD.NUN
adad	IM
adama	BAD.MI
adamen	LU2%LU2
adamen2	LUGAL&LUGAL
adamen3	GIŠ%GIŠ
adamen4	NUN%NUN
adamen5	EN%EN
adamenx(|LUGAL@LUGAL|)	LUGAL@LUGAL
adamin	LU2@LU2
adamin2	LUGAL&LUGAL
adamin3	GIŠ%GIŠ
adamin4	NUN%NUN
adamin5	EN%EN
adaminx(|EN@EN|)	EN@EN
adaminx(|LU2.LU2|)	LU2.LU2
adamu	BAD.MI
adar	A.GUD×KUR
adar2	GUD×KUR
adar3	GEŠTIN×KUR
adarx(SUD2)	SUD2
adax(|LU2×BAD|)	LU2×BAD
adda	LU2×BAD
adda2	LU×BAD
adda3	U2.GIR2@g
adda4	GIR2@g
addax(LU2)	LU2
addax(ZA@t)	ZA@t
addax(|LU2@g.UŠ2|)	LU2@g.UŠ2
addir	A.PA.GISAL.PAD.SI.A
addirx(PA)	PA
addirx(|GISAL.PAD.SI.A|)	GISAL.PAD.SI.A
addirx(|PA.GISAL.SI.A.PAD|)	PA.GISAL.SI.A.PAD
addirx(|PA.GISAL.SI.A|)	PA.GISAL.SI.A
addirx(|PAD.DUG.GIŠ.SI|)	PAD.DUG.GIŠ.SI
addirx(|SI.GIŠ.PAD.DUG|)	SI.GIŠ.PAD.DUG
addu2	U2.GIR2@g
addu3	GIR2@g
addu4	ZA@t
adkin	SIK2.LAM
adx(EN)	EN
adx(LU2@s)	LU2@s
adx(|BAD.LU2|)	BAD.LU2
adx(|LU2@s×BAD|)	LU2@s×BAD
adx(|LU2×GAM|)	LU2×GAM
ag	AK
ag2	NINDA2×NE
ag3	ŠID
aga	DUN3@g@g
aga-us2	DUN3@g.UŠ
aga2	NINDA2×NE
aga3	DUN3@g
agal	KA×GAL
agam	A×BAD
aganx(KA2)	KA2
agar2	LAGAB×IGI@g
agar3	LAGAB×A+GAR
agar4	IGI@g
agar5	IM%IM
agar6	IM.DUGUD
agargara	NUN@t
agargarax(NUN)	NUN
agarim	GA2×AN.AN.MUŠ3
agarin	AB×DUN3@g
agarin2	AB×GAN2@t
agarin3	GA2×AN.DUN3@g
agarin4	GA2×AN.ŠIM
agarin5	GA2×AN.ŠIM×GAR
agarinx(AB)	AB
agaš	BAD.X
agrig	IGI.DUB
agrigx(|IGI.ZI|)	IGI.ZI
agrun	E2.NUN
agrunax(E2.NUN)	E2.NUN
agrunax(|E2.NUN|)	E2.NUN
agrux(E2.NUN)	E2.NUN
agrux(|E2.NUN|)	E2.NUN
agu	DUN3@g@g
agx(|NINDA2×ŠE|)	NINDA2×ŠE
ah	HI×NUN
ah2	ŠEŠ
ah3	UD
ah4	ALEPH
ah5	A2
ah6	UD.KUŠU2
aha	HI×NUN
aha2	ŠEŠ
aha3	PAP
ahhur?	IGI.A
ahi	ŠEŠ
ahi2	A2
ahud	IM×4
ai	A.A
aia	A.A
aia2	A
aia3	UR
aia4	LAGAB×A
ak	AK
ak3	ŠID
aka	AK
aka2	NINDA2×NE
aka3	ŠID
aka4	KA2
akan	DAG.KISIM5×GA
akan2	KA2
akan3	LAGAB×LU
akani	DAG.KISIM5×GA
akar	NUN%NUN.LAGAR&LAGAR
akarx(|(NUN.LAGAR×SAL)&(NUN.LAGAR×SAL)|)	(NUN.LAGAR×SAL)&(NUN.LAGAR×SAL)
akix(AK)	AK
akkan3	LAGAB×LU
akkil	GAD.TAK4.SI
akkil2	AD.KID
akkil3	GAD.TAK4
akkilx(|AD.E2|)	AD.E2
aktum	A.SU
aktum2	SU.A
akx(|KA×AD|)	KA×AD
akšak	UD.KUŠU2
akšak2	A.KUŠU2
akšak3?	UD@s.KUŠU2
akšakx(|EZEN×HA|)	EZEN×HA
al	AL
al2	ALAN
al3?	GAN2
al5	UD
al6	MAH
al8	URU
ala	URU
ala2?	URU.ME.U.U.U
ala3	AL
alad	KAL×BAD
alad2?	KAL
alag	ALAN
alal	ŠID×A
alal2	ŠID
alal3	GIŠ%GIŠ
alal4?	GAN2%GAN2
alala	ALAN
alalmu	ŠID×A
alalx(GAN2)	GAN2
alam	ALAN
alamax(NIM)	NIM
alammuš	TA×HI
alamu	ŠID×A
alamu2	ŠID
alamuš	TA×HI
alamx(|ALAN&ALAN|)	ALAN&ALAN
alan	ALAN
alap	GUD
alax(|KA×A+LA2|)	KA×A+LA2
alax(|ŠID×A|)	ŠID×A
alaĝ	ALAN
alba	GA2
alba2	KASKAL.KUR
ale	URU
algames	UD.SAL.HUB2
algameš	UD.SAL.HUB2
algamis	UD.SAL.HUB2
alha	KASKAL.KUR
ali	URU
alim	GIR3×A+IGI
alima	GIR3×A+IGI
alimx(|GIR3×IGI|)	GIR3×IGI
alimx?(|GA2×A+IGI|)	GA2×A+IGI
alla	NAGAR
almu	ŠID×A
almu2	ŠID
alpu	GUD
alu	URU
alurx(BAHAR2)	BAHAR2
am	GUD×KUR
am2	NINDA2×NE
am3	A.AN
am4?	GA2×KAK
am5	GA2×SAL
am6	AN
am7	PI
ama	GA2×AN
ama2	GUD×KUR
ama3?	GI.LU
ama4	GA2×KAK
ama5	GA2×SAL
ama6	LAGAB×AN
amagi	MUŠ3×A+DI
amagi2	A.MUŠ3.DI
amagi3	ZA.MUŠ3.DI
amagi4	ZA.MUŠ3@g.DI
amagix(|A.MUŠ3×A.DI|)	A.MUŠ3×A.DI
amagix(|MUŠ3.DI|)	MUŠ3.DI
amagix(|MUŠ3×DI|)	MUŠ3×DI
amah	LAGAB×U+A
amalu	GA2×AN.AN.MUŠ3
amalug?	GA2×AN.LUL
aman	PAP.PAP
amar	AMAR
amarim?	GA2×AN.AN.MUŠ3
amat	SAL.KUR
amax(|E2.SAL|)	E2.SAL
amax(|E2×SAL|)	E2×SAL
amaš	DAG.KISIM5×LU+MAŠ2
amaša	DAG.KISIM5×LU+MAŠ2
ambar	LAGAB×A
ambara	LAGAB×A
ambarx(|LAGAB×GAR|)	LAGAB×GAR
ame	GA2×AN
ame2	GA2×SAL
amex(|E2.SAL|)	E2.SAL
ami	GA2×AN
ami2	GA2×SAL
amma	KUR
ammax(KI)	KI
ammax(|GA2×AN|)	GA2×AN
amna	UD
amna2	U.U
amra	GIŠ.MA2.RA
amtu	SAL.KUR
amuru	KID.MAH
amuš	A×MUŠ
amuša	A×MUŠ
amx(EN)	EN
an	AN
an-na	AN.NA
an2?	GIŠ%GIŠ
ana	DIŠ
ana2	AN
ana3	AŠ
anbar	LAGAB×A
anegi	IM
angar	IM%IM
angur	LAGAB×HAL
aniku	NA
anu	AN
anubu	KUR
anx(DIŠ)	DIŠ
anx(|EZEN×BAD|)	EZEN×BAD
anzalub	ŠA3.GI
anzu	AN.IM.DUGUD
anzu2	AN.IM.MI
anzud	AN.IM.DUGUD
anzud2	AN.IM.MI
anzux(|AN.HU.MI.IM|)	AN.HU.MI.IM
anzux(|HU.MI.AN.IM|)	HU.MI.AN.IM
anše	ANŠE
anše2	GIR3
anšex(|ANŠE.PA|)	ANŠE.PA
anši	GIR3×PA
anšu	ANŠE
anšu2	GIR3
anšux(|ANŠE.PA|)	ANŠE.PA
ap	AB
ap2	AB2
ap3	AD
apin	APIN
apina	APIN
aq	AK
aqa	AK
ar	IGI.RI
ar...	UR2×U2+BI
ar2	UB
ar3	HI×AŠ2
ar5	GAM
ara	ŠA
ara2	UB
ara3	HI×AŠ2
ara4	UD.DU
ara5	HI×AŠ2.HI×AŠ2
ara7	UD
ara8	IGI.RI
arab	UD.NUN
arad	ARAD
arad2	ARAD×KUR
arad3?	LAM×KUR
aragub	DU
arah3	GA2×ŠE
arah4	E2.UŠ.BU.DA
araha	E2.UŠ.BU.DA
arahx(|E2×ŠE|)	E2×ŠE
arahx(|UŠ.BU.DA|)	UŠ.BU.DA
arala	E2.KUR.BAD
arali	E2.KUR.BAD
aralix(|URU×GAL|)	URU×GAL
arar	UD.AB@g
ararama	UD.AB@g
ararama2	UD.AB
ararim	URU×A
ararimx(|URU×UD|)	URU×UD
ararma	UD.AB@g
ararma2	UD.AB
arata	LAM×KUR+RU
aratta	LAM×KUR+RU
araţa	LAM×KUR+RU
arba	LIMMU2
arda	ARAD
argab	GAR.IB
arhu	UD×U+U+U
arhus2	NUN.LAGAR×SAL
arhuš	GA2×SAL
arhuš2	NUN.LAGAR×SAL
arhuš3	NUN.LAGAR×MAŠ
arhuš4?	GA2×AN
arhuš5	A2.TUR
arhuš6	A2.SAL
arhuš7	A2.GA2×SAL
arhušx(|E2×SAL|)	E2×SAL
ari	URI
ari2	IDIM
ari3	PA
ari5?	PA.ME.U.U.U
ari6	SUM
arina	MUŠ%MUŠ.A.NA
arinax(|A.LU2@s.NA|)	A.LU2@s.NA
arinax(|I.LU2@s.NA|)	I.LU2@s.NA
arinax(|LU2@s.NA|)	LU2@s.NA
arinax(|MUŠ&MUŠ.A.NA|)	MUŠ&MUŠ.A.NA
arinax(|MUŠ&MUŠ×A+NA|)	MUŠ&MUŠ×A+NA
arinax(|UR2×A|)	UR2×A
arkab	GAR.IB
arkab2	ARKAB2
arkabx(IB)	IB
arkabx(|ARKAB2.IB|)	ARKAB2.IB
arrap	LIMMU2
aru	PA
arx(|URU×A|)	URU×A
as	PIRIG×ZA
as2	AŠ2
as3	AŠ
as4	LAGAB×A
as4-lum	LAGAB×A.LUM
as5	ŠIR
as6	HI×DIŠ
asa	PIRIG×ZA
asa2	AŠ2
asag	KU3.AN
asagx(|GA2×ŠE|)	GA2×ŠE
asal	URU×IGI
asal2	A.TU.GABA.LIŠ
asalx(|A.GABA.LIŠ.TU|)	A.GABA.LIŠ.TU
asalx(|A.GIŠ.TU.GABA.LIŠ|)	A.GIŠ.TU.GABA.LIŠ
asalx(|A.TU.GABA.SIG.GAR|)	A.TU.GABA.SIG.GAR
asalx(|A.TU.GABA|)	A.TU.GABA
asalx(|A.TU.NUN&NUN|)	A.TU.NUN&NUN
asalx(|A.TU|)	A.TU
asalx(|ASAL2~a|)	ASAL2~a
asalx(|GABA.LIŠ|)	GABA.LIŠ
asalx(|KA×IGI|)	KA×IGI
asalx(|TU.NUN&NUN.LIŠ.A|)	TU.NUN&NUN.LIŠ.A
asar	URU×IGI
asar2	A.TU.GABA.LIŠ
asara	URU×IGI
asari	URU×IGI
asaru	URU×IGI
asax(|KU3.AN|)	KU3.AN
asax(|URU×IGI|)	URU×IGI
asi	A.ŠE.NUN&NUN
asil	EZEN×LAL2
asil3	EZEN×A
asil4	EZEN×A+LAL2
asil5	EZEN×A+LAL
asil6	EZEN×UD
asila	EZEN×LAL2
asila2	ŠIM
asila3	EZEN×A
asila4	EZEN×A+LAL2
asila5	EZEN×A+LAL
asila6	EZEN×UD
asilal	EZEN×LAL2
asilal2	ŠIM
asilal3	EZEN×A
asilal4	EZEN×A+LAL2
asilal5	EZEN×A+LAL
asilal6	EZEN×UD
asilalx(EZEN)	EZEN
asilax(EZEN)	EZEN
asilax(|EZEN×KASKAL|)	EZEN×KASKAL
asilla2	ŠIM
asillal3	EZEN×A
asilx(EZEN)	EZEN
aski	AŠ.HI×DIŠ.GI4
aslum	LAGAB×A
aslumx(|A.LUM|)	A.LUM
aslumx(|LAGAB×GAR|)	LAGAB×GAR
asx(|LAGAB×GAR|)	LAGAB×GAR
at	AD
at2	GIR2@g
atum	NI.UD.KI
atumx(|NI.UD|)	NI.UD
atumx(|UD.NI|)	UD.NI
au	A.PA.GISAL.PAD.SI.A
aux(|GISAL.PAD.SI.A|)	GISAL.PAD.SI.A
aw	PI
ax(DA)	DA
aya	A.A
aya2	A
aya2-aya2	A×A
aya3	UR
aya4	LAGAB×A
ayax(HA)	HA
ayax(UD)	UD
ayax(|LAGAB×GAR|)	LAGAB×GAR
aye	A.A
ayi	A.A
ayu	A.A
ayya	A.A
ayye	A.A
ayyi	A.A
ayyu	A.A
az	PIRIG×ZA
az2	AŠ2
az3	AŠ
aza	PIRIG×ZA
azad	U2.A.LAGAB×KUL.MA2.ŠU2.A
azad2	TAK4
azadx(|A.LAGAB×HAL.ŠU2|)	A.LAGAB×HAL.ŠU2
azag	KU3.AN
azag2	A2.PA
azak	KU3.AN
azalag	TUG2.UD
azalag2	TUG2
azalag3	GIŠ.TUG2.PI.TE.A.DU
azalag4	GIŠ.TUG2.TE.A.DU
azalag5	GIŠ.TUG2.PI.TE.A
azalag6	GIŠ.TUG2.TE.A
azalag7	LU2×TUG2
azalx(|A.TU.GABA.LIŠ|)	A.TU.GABA.LIŠ
azlag	TUG2.UD
azlag2	TUG2
azlag3	GIŠ.TUG2.PI.TE.A.DU
azlag4	GIŠ.TUG2.TE.A.DU
azlag5	GIŠ.TUG2.PI.TE.A
azlag6	GIŠ.TUG2.TE.A
azlag7	LU2×TUG2
azlaggalx(|GAL.GIŠ.TUG2.TE.A.DU|)	GAL.GIŠ.TUG2.TE.A.DU
azu	ZU5×A
azubirx(|HI×AŠ2.SAG|)	HI×AŠ2.SAG
azugna	HI×AŠ2.SAG
azukna	HI×AŠ2.SAG
aĝ	AK
aĝ2	NINDA2×NE
aĝ3	ŠID
aĝa3	DUN3@g
aĝar5	IM%IM
aĝar6	IM.DUGUD
aĝarin	AB×DUN3@g
aĝarin2	AB×GAN2@t
aĝarin3	GA2×AN.DUN3@g
aĝarin4	GA2×AN.ŠIM
aĝarin5	GA2×AN.ŠIM×GAR
aĝrig	IGI.DUB
aś	AŠ2
aş	PIRIG×ZA
aş2	AŠ2
aş3	AŠ
aš	AŠ
aš10	DIŠ
aš11	AŠ@z
aš2	AŠ2
aš2-gar3	SAL.AŠ2.GAR3
aš4	TAB.TAB.TAB
aš5	SIK2.LAM.SUHUR
aš6	SIK2.LAM
aš7	ŠIR
aš7-gi4	ŠIR.GI4
aš8	HI×DIŠ
aš9	AŠ&AŠ&AŠ.AŠ&AŠ&AŠ
aša	AŠ
aša2	AŠ2
aša5	GAN2
ašag	GAN2
ašalx(|A.TU.GABA.LIŠ|)	A.TU.GABA.LIŠ
ašalx(|A.TU.NUN&NUN|)	A.TU.NUN&NUN
ašar2	A.TU.GABA.LIŠ
ašaridu	IGI.DU
ašarx(|A.TU.NUN&NUN|)	A.TU.NUN&NUN
ašdar	U.DAR
ašdarx(|DIŠ.DAR|)	DIŠ.DAR
ašgab	AŠGAB
ašgabgalx(|GAL.AŠGAB|)	GAL.AŠGAB
ašgi	ŠIR.GI4
ašita	A2.U.KID
aški	ZI&ZI.LAGAB
aškix(|A.ZI&ZI|)	A.ZI&ZI
aškix(|ZI&ZI.A|)	ZI&ZI.A
aškix(|ZI&ZI.EŠ2|)	ZI&ZI.EŠ2
aškud	A2.MUŠ3@g
aškud2	A2.MUŠ3
aškudx(|A.ZA.AN.MUŠ3|)	A.ZA.AN.MUŠ3
aškudx(|A2.ZA.MUŠ3@g|)	A2.ZA.MUŠ3@g
ašlag	TUG2.UD
ašlag2	TUG2
ašlag3	GIŠ.TUG2.PI.TE.A.DU
ašlag4	GIŠ.TUG2.TE.A.DU
ašlag5	GIŠ.TUG2.PI.TE.A
ašlag6	GIŠ.TUG2.TE.A
ašlag7	LU2×TUG2
ašlug	E2.UŠ.BU.DA
ašnan	ŠE.ŠE.NUN&NUN
ašnan2	ŠE
ašnana	ŠE.ŠE.NUN&NUN
ašta	GAD.TAK4
ašte	A2.U.KID
ašte2	LAGAB×A
aštex(|LAGAB×GAR|)	LAGAB×GAR
ašx(AB)	AB
ašša	AŠ
ašša2	GAD.TAK4
aššan	AN.DU.AN
aţ	AD
aţ2	GIR2@g
aţu	U2.GIR2@g
ba	BA
ba10?	PAN
ba11	KA×GAN2@t
ba13	ME
ba14	PAP
ba15	BAR
ba2	PA
ba3	U.U.U
ba4	GA2
ba5?	KA×IM
ba6	U2
ba7	MAŠ
ba8	EZEN×BAD
ba9	BAD
bab	PAP
bab2	UD
baba2	KA2
babar	UD
babar2	UD.UD
babbar	UD
babbar2	UD.UD
babila	KA.AN
babila2	KA.AN.RA
babilax(|DIN.ŠE.NUN&NUN|)	DIN.ŠE.NUN&NUN
babilax(|KA2.AN|)	KA2.AN
babilim	KA2.AN
babilim2	KA2.AN.RA
babilima	KA2.AN
babilima2	KA2.AN.RA
babu	KA2
bad	BAD
bad2	PAD
bad3	EZEN×BAD
bad4	KI.KAL
bad5	IGI
bada	BAD
bada3	EZEN×BAD
badi	IGI
badx(EZEN)	EZEN
baeš	AŠ2
bag	HU
bag2	AŠ@z.AŠ@z.AŠ@z.AŠ@z
bag3	BAG3
bag4	AŠ@k&AŠ@k&AŠ@k&AŠ@k
bagx(RI)	RI
bah	HU
bah3	LUL
bahar	GUD
bahar2	BAHAR2
bahar3	U.EDIN
bahar4	BAR.EDIN
bahar5	DUG.SILA3.BUR.NA
bahargalx(|GAL.BAR.EDIN|)	GAL.BAR.EDIN
baharx(|U.SAR|)	U.SAR
bak	HU
bak2	AŠ@z.AŠ@z.AŠ@z.AŠ@z
bak3	BAG3
bakiru	U.SAR
bakirum	U.SAR
bakx(RI)	RI
bal	BAL
bal2	BUR2
bal3	AL×AL
bal4	AL×KI
bala	BAL
balag	BALAG
balak	BAL
balaĝ	BALAG
baliha	KASKAL.KUR
balla	GAR.SAG.IL2.EZEN.UŠ
balla2	GAR.SAG.IL2.EZEN.SAL
ballatu	ZI.ME.U.U.U
ban	PAN
ban3	TUR
ban4	KAK
banda3	TUR
banda4	IDIM
banda5	SIG4.IDIM
bandiliša	KU7
baneš	AŠ2
bania	AŠ2.U&U
banlimmu	AŠ2.U
bansur	URU×URUDA
bansur2	IDIM&IDIM.BUR
bansur3	KAD5
banx(|LAGAB.LAGAB|)	LAGAB.LAGAB
banšur	URU×URUDA
banšur2	IDIM&IDIM.BUR
banšur3	KAD5
banšura	URU×URUDA
banšurx(|URU×IGI|)	URU×IGI
bap	PAP
bappir	ŠIM×GAR
bappir2	ŠIM
bappir3	BI×GAR
bappira	ŠIM×GAR
bappira2	ŠIM
bappira3	BI×GAR
baq	HU
bar	BAR
bar2	BARA2
bar3	DAG
bar4	NI.UD
bar5	SIG4
bar6	UD
bar7	NE
bar8	EN×GAN2@t
bara	BAR
bara10	GA2×IGI@g
bara2	BARA2
bara2-munu4	BARA2.PAP.PAP
bara2-munu5	BARA2.PAP.ŠE.PAP
bara3	DAG
bara4	BAD
bara5	LAGAB×EN
bara6	LAGAB×ME+EN
bara7	LAGAB×IGI@g
bara8	LAGAB×TAK4
bara9	LAGAB×LUL
barag	BARA2
barag2	DAG
baragx?(|E2×BAD|)	E2×BAD
barax(NE)	NE
barax(UD)	UD
bare	BAR
bargi?	U&U.U@v&U@v
barim	PA.DU@s
barimx(|URU×BAR|)	URU×BAR
barx(A)	A
barx(U)	U
barzil	AN.AŠ.AN
bat	BAD
bat2	PAD
bat3	EZEN×BAD
bat5	IGI
bata	BAD
batu	U.U.U
bax(PI)	PI
bazbazx(|ŠE.HU|)	ŠE.HU
baš?	MAŠ
baštum	KAL
baţ	BAD
be	BAD
be2	BI
be3	NI
be4	BA
be5	KU
be6	PI
be7	NE
bed	E2
bed3	KU
belili	ALAN
ber2	UD
ber6	ŠA3×U+A
ber7	ŠA3×A
bet	E2
bet3	KU
beš12	UD
bi	BI
bi2	NE
bi3	PI
bi4	BAD
bi5	NE@s
bi6	BA
bi7	KU
bi9?	HI×NUN
bibad	ŠE.HU.TUR
bibe	ŠE.HU.TUR
bibra	HUL2
bibri	HUL2
bid	E2
bid2	BAD
bid3	KU
big	SIG
bik	SIG
bil	NE
bil2	NE@s
bil3	GIŠ.NE@s
bil4	GIŠ.NE
bila	NE
bili	NE
billuda	PA.AN
billudu	PA.AN
biltu	GU2.UN
biluda	PA.AN
bilx(EDIN)	EDIN
bin	APIN
bir	HI×ŠE
bir2	UD
bir3?	ERIN2
bir4	EDIN
bir5	NAM
bir6	ŠA3×U+A
bir7	ŠA3×A
bir8	A.SUD
bir9	NE
birdu	KAL.EDIN
biri	HI×ŠE
birx(|ŠIM×GAR|)	ŠIM×GAR
bis2	HA@g
bisag	GA2
bisag2	ŠID
bisag3	ŠID×A
bisagx(|GA2×GI|)	GA2×GI
bisan	GA2
bisan2	ŠID
bisan3	ŠID×A
bisanx(|GA2×GI|)	GA2×GI
bisaĝ	GA2
bisaĝ2	ŠID
bisaĝ3	ŠID×A
bit	E2
bit3	KU
bix(NAM)	NAM
biz	BI
bizeg3	ŠID×A
bizem3	ŠID×A
biš	HA@g
bišeba	LUGAL
bišeba3?	GUD&GUD.LUGAL
bišebi	LUGAL
bišebi3?	GUD&GUD.LUGAL
biţ	E2
bu	BU
bu10	PAP.PAP
bu11	U2
bu12	U
bu13	KA×IM
bu14	LAGAB×SUM
bu15	PAD
bu2	KASKAL
bu3	KA×GAN2@t
bu4	LAGAB×U
bu5	LAGAB×U+U+U
bu5-bu5	LAGAB×U+U+U.LAGAB×U+U+U
bu6	LAGAB×U
bu7	KU
bu8	BUR2
bu9?	BULUG
bubbu	LAGAB×U+U+U.LAGAB×U+U+U
bubbur	BUR2.BUR2
bube	KU7
bubux(|LAGAB×U+U+U.LAGAB×U+U+U|)	LAGAB×U+U+U.LAGAB×U+U+U
bugin	LAGAB×A
bugin2	LAGAB×GAR
bugin3?	LAGAB×ME
bugin4	LAGAB×U+A
buglu	ŠA3.GI
buh	LUL
buhx(|KA×IM|)	KA×IM
buk	MUG
bul	LAGAB×U+U+U
bul2	BUR2
bul3	BAL
bul4?	KA×IM
bul5	LAGAB×SUM
bula	KU.NU
bulug	BULUG
bulug2	BUR2
bulug3	PAP.PAP
bulug4	NAGAR
bulug5	BALAG
buluh	HAL
bulunx(BALAG)	BALAG
bulunx(|PAP.PAP|)	PAP.PAP
buluĝ	BULUG
buluĝ3	PAP.PAP
buluĝ5	BALAG
bulx(KU)	KU
bum	KA×GAN2@t
bum2	BALAG
bun	LAGAB×IM
bun2	KA×IM
bunga	UŠ.GA
bungu	UŠ.GA
bunig3?	LAGAB×HAL
bunin	LAGAB×A
bunin2	LAGAB×GAR
bunin3?	LAGAB×ME
bunin4	LAGAB×U+A
buninx(|A.LAGAB×A|)	A.LAGAB×A
buniĝ	LAGAB×A
buniĝ2	LAGAB×GAR
buniĝ3?	LAGAB×HAL
buniĝx(A)	A
buniĝx(|A.LAGAB×A|)	A.LAGAB×A
bunx(|URU×IM|)	URU×IM
bur	BUR
bur'ux(|U×KASKAL|)	U×KASKAL
bur10	LAGAB×U+U+U
bur11	KI.EN.KAK
bur12	BU
bur13	PAP.PAP
bur14	EN×GAN2@t
bur2	BUR2
bur3	U
bur4	NU11.BUR
bur5	HU.ŠE.ERIN2
bur6	KISAL
bur7	GURUN
bur8	HAL
buranun	UD.GIŠ%GIŠ.NUN
buranuna	UD.GIŠ%GIŠ.NUN
buranunu	UD.GIŠ%GIŠ.NUN
buru	BUR
buru11	KI.EN.KAK
buru14	EN×GAN2@t
buru15	NU11.IR
buru16	LAGAB×SUM
buru2	BUR2
buru3	U
buru4	NU11.BUR
buru5	NAM@n
buru6	KID
buru7	GURUN
buru8	HAL
buru9	IDIM&IDIM.BUR
burudx(U)	U
buruh	HAL
burumx(|IGI.ERIN2|)	IGI.ERIN2
burunun	UD.GIŠ%GIŠ.NUN
burununa	UD.GIŠ%GIŠ.NUN
burux(GAN2)	GAN2
burux(HU)	HU
burux(|BAD.IGI.BAD|)	BAD.IGI.BAD
burux(|IDIM&IDIM×4|)	IDIM&IDIM×4
burux(|IDIM×4|)	IDIM×4
burux(|IGI.ERIN2|)	IGI.ERIN2
burux(|LAGAB×4|)	LAGAB×4
burux(|LAGAB×U+U+U|)	LAGAB×U+U+U
burux(|TAB×4|)	TAB×4
burx(A)	A
burx(|BAD.IGI.BAD|)	BAD.IGI.BAD
burx(|IDIM&IDIM.BUR|)	IDIM&IDIM.BUR
burx(|IDIM&IDIM×4|)	IDIM&IDIM×4
burx(|IDIM×4|)	IDIM×4
burx(|KA×GAN2@t|)	KA×GAN2@t
burx(|KA×ŠU|)	KA×ŠU
burx(|TAB×4|)	TAB×4
bute	ZAG
buti	ZAG
butu	ZAG
bux(KA)	KA
bux(NI)	NI
bux(PI)	PI
buzur	U
buzur2	U.U
buzur3	U.ZAG
buzur4	KA×GAN2@t.ŠA
buzur5	KA×GAN2@t
buš	KASKAL
buš2	HA@g
bītu	E2
būdu	ZAG.HA
d	AN
da	DA
da10	HI
da11?	IG
da12	KA
da13	TAK4
da2	TA
da3	KAK
da4	DAM
da5	URUDA
da6	TAG
da7	UD
da8	DAG
da9	UMUM×KASKAL
dab	DIB
dab2	TAB
dab3	HI
dab4	DUB
dab5	KU
dab6	URUDA
daba	DIB
daba5	KU
daban	KU7
dabax(NUN)	NUN
dabašin	KU7
dabda2	BAD.BAD
dabda?	IGI.IGI
dabe	DIB
dabin	EŠ2.ŠE
dabx(NUN)	NUN
dabx(|LAGAB×GUD|)	LAGAB×GUD
dad	TAK4
dadag	UD.UD
dadda	TAK4.TAK4
dadrum?	LUGAL&LUGAL
dag	DAG
dag2	UD
dag3	NI.UD
dag4?	KISAL
dag5	KA
dagal	GA2×AN
dagala	GA2×AN
dagan?	KI.URU×MIN
daggan?	KI.URU×MIN
dagrim	LAGAB×KU3
dagrin	LAGAB×KU3
dagx(|GA2×U|)	GA2×U
dagx?(|E2×BAD|)	E2×BAD
dah	MU&MU
dak	DAG
dak3	NI.UD
dakan	KI.URU×MIN
dal	RI
dal2?	MAŠ.GU2.GAR3
dal3	AŠ
dala	RI
dala2	IGI.KAK
dalhamun	IM.ŠITA
dalhamun2	EN%EN
dalhamun3	EN%EN.IM%IM
dalhamun4	AN+NAGA×4
dalhamun5	AN+NAGA@AN+NAGA
dalhamun6	IM%IM
dalhamun7	NAGA@NAGA
dalhamunx(AN)	AN
dalhamunx(IM)	IM
dalhamunx(|IM@IM|)	IM@IM
dalla	MAŠ.GU2.GAR3
dalla2	IGI.KAK
dallax(|GU2.GAR3|)	GU2.GAR3
dalx(HU)	HU
dam	DAM
dam2	UD
dam3	TUM
dama	DAM
damal	GA2×AN
damu	TUR
damu2	IGI
dan	KAL
dan2	GA2×ME+EN
dan3	GA2×TAK4
dan4	GA2×GAN2@t
dan5?	DIN
dan6	UŠ×TAK4
dan7	GA2×DA
dana	KASKAL.BU
dana2	KASKAL
dana3	KAL
danna	KASKAL.BU
danna2	KASKAL
dannu	KAL
dap	DIB
dap2	TAB
dapa2	TAB
dapar	GUD
dapara	GUD
daparax(|LU2.EN|)	LU2.EN
daparax(|LU2.LU2.LU2.LU2|)	LU2.LU2.LU2.LU2
daparu	LU2.ME.EN
daq	DAG
daq3	NI.UD
dar	DAR
dar2	IB
dar3	DARA3
dar4	DARA4
dar6	TAR
dara2	IB
dara3	DARA3
dara4	DARA4
dara5	GIŠ%GIŠ
daramx(NA2)	NA2
darax?(|KU.GIŠ%GIŠ|)	KU.GIŠ%GIŠ
darengal	UD.NUN
dari2	IB
dari5	GIŠ%GIŠ
darix?(|KU.GIŠ%GIŠ|)	KU.GIŠ%GIŠ
daru2	IB
daru5	GIŠ%GIŠ
darum2	IB
darux?(|KU.GIŠ%GIŠ|)	KU.GIŠ%GIŠ
das	UR
dat	TAK4
dax(DAR)	DAR
dax(PI)	PI
daĝal	GA2×AN
daĝalx(|GA2×LA|)	GA2×LA
daš	UR
daš2	DIŠ
daš3	AŠ2
daš4?	DAR
de	DI
de2	UMUM×KASKAL
de3	NE
de4	TE
de5	RI
de6	DU
de8	HI
de9	TI
deb	DIB
deb2	KU
degx(RI)	RI
deh	DUB
deh2	UM
deh3	NIM
dehi	DUB
dehi2	UM
dehi3	NIM
dehi4	IDIM
del	AŠ
del2	LIŠ
del4	AŠ@z
dele	AŠ
dele4	AŠ@z
delen	LAGAB×IM
delen2	ŠU.LAGAB.NA
delen3	LAGAB×GAR
delena	LAGAB×IM
delena2	ŠU.LAGAB.NA
delena3	LAGAB×GAR
deli	AŠ
dellu	MA2.MUG
dellux?(|MA2.KAK|)	MA2.KAK
delmun	NI.TUK
dem2	DIM2
dema	KA.HI
demma	KA.HI
demmu	KA.HI
demu	KA.HI
den	DIN
dergul	MA2.MUG
dex(NI)	NI
dex(|UMUM×PA|)	UMUM×PA
dex-dex(|TUR.TUR|)	TUR.TUR
deš	DIŠ
deš2	AŠ
deš3	UR
deš4?	ME
deš5	AŠ@z
deššu	AŠ2
di	DI
di11	DIM
di12	TE
di2	HI
di3	TI
di4	TUR
di4-di4	TUR.TUR
di5	RI
di6	DU
di7	NE
di8	UMUM×KASKAL
di[...]ig	IM
dib	DIB
dib2	KU
dib5	LAGAB×GUD
dibi	DIB
dibira	DUB.NAGAR
dibur	AN
dibx(|LAGAB×GUD+GUD|)	LAGAB×GUD+GUD
dibx(|SIK2.AŠ|)	SIK2.AŠ
did?	IM
dida	BI.U2.SA
dida2	UŠ.SA
didala?	ŠA3
didalx(NE)	NE
didanu	PIRIG.PIRIG
didanum	PIRIG.PIRIG
didax(|U2.SA|)	U2.SA
didli	AŠ.AŠ
didnu	PIRIG.PIRIG
didnum	PIRIG.PIRIG
dig	NI
digbir	KI.NE.AN.MUŠ3
digi	NI
digir	AN
dih	DUB
dih2	UM
dih3	NIM
dihi	BAD
dihi2	UM
dihi3	NIM
dik	NI
dil	AŠ
dil4	AŠ@z
dili	AŠ
dili2	LIŠ
dili4	AŠ@z
dilib	ŠID
dilib2	KA×ŠID
dilib3	SAG×ŠID
dilib4	SAG×NUN
dilib5	SAG×UŠ
dilib6	SAG×SAL
dilim	LAGAB×IM
dilim2	LIŠ
dilim3	LAGAB×IM
dilim4	ŠU.LAGAB.NA
dilim5	LAGAB×GAR
dilin	LAGAB×IM
dilin2	ŠU.LAGAB.NA
dilin3	LAGAB×GAR
dilina	LAGAB×IM
dilina2	ŠU.LAGAB.NA
dilina3	LAGAB×GAR
dilmun	NI.TUK
dilmuna	NI.TUK
dilmunx(|SAL.TUK|)	SAL.TUK
dilur	MA2.MUG
dilurx(|MA2.KAK|)	MA2.KAK
dilx(SAG@g)	SAG@g
dim	DIM
dim10	RAB.HI×BAD
dim11	LUGAL.HI×BAD
dim12	ŠID
dim13	BU
dim2	DIM2
dim3	LUGAL@s
dim4	PAP.PAP
dim5	DUB2
dim6?	UMUM×KASKAL
dim7	BAD
dim8	RAB.GAN
dim9	LUGAL.GAN
dima	KA.HI
dima2	DIM2
dimer	AN
dimgul	MA2.MUG
dimir	AN
dimma	KA.HI
dimmer	AN
dimmu	KA.HI
dimmuš	U2.GIŠ.MI
dimmušx?(|GIŠ.MI|)	GIŠ.MI
dimna	U.GA
dimsar	IGI&IGI.ŠIR&ŠIR.UD&UD
dimu	KA.HI
dimuš	U2.GIŠ.MI
dimx(LU2@s)	LU2@s
dimx(|LUGAL.GAM|)	LUGAL.GAM
din	DIN
din-tir	DIN.ŠE.NUN&NUN
diner	AN
dingir	AN
dingira	AN
dini	DIN
dinig	KI.NE
dinig2	LU2×ME+EN
dinig3	LU2×LAGAB
dinir	AN
dinx(EDIN)	EDIN
dip	DIB
dipar	GUD
diq	NI
dir	SI.A
dir2	DAR
dir3	AN
dir4	ŠE.NUN&NUN
dirgul	MA2.MUG
dirgulx(|MA2.KAK|)	MA2.KAK
diri	SI.A
diri2?	IB
dirig	SI.A
disgur	AMAR×ŠE
dix(DA)	DA
dix(DIB)	DIB
dix(DIM2)	DIM2
diĝir	AN
diš	DIŠ
diš2	AŠ
diš4?	ME
diša	DIŠ
du	DU
du10	HI
du11	KA
du12	TUK
du13	TUR
du13-du13	TUR.TUR
du14	LU2×NE
du15	HI×BAD
du16	UD×U+U+U
du17?	NE
du19?	UMUM×KASKAL
du2	TU
du20	DA
du24	DUN
du25	ANŠE.ARAD
du26	SI.A
du3	KAK
du4	TUM
du5	DUN3
du6	LAGAR@g
du7	U.GUD
du8	GABA
du9	BUR2
dub	DUB
dub2	DUB2
dub3	HI
duba	DUB
duba2	DUB2
dubad	KI.KAL
dubal	AL×KAD3
dubal2	AL×KI
dubal3	LU2×KAD2
dubal4	LU2×KAD3
dubal5	LU2×AL
dubal6	LU2×KI
dubal7	LU2×TUG2
dubba	DUB
dubu	DUB
dubu2	DUB2
dubul	ŠU.BU
dubur	HI×ŠE
dubur2	HI×U
dubx(|NE.SI.A|)	NE.SI.A
dubx?(MES)	MES
dud	PA.UZU
dud2	TU
duda	PA.UZU
dudda	GABA
duddu	TUK.TUK
dudu	KI.IB
dudux(|PA.UZU|)	PA.UZU
dug	DUG
dug3	HI
dug4	KA
dug5	DUN3
duga3	HI×NUN
duga4	KA
dugax(LUL)	LUL
dugin	EZEN×DUN3@g
dugin2	EZEN×DUN3@g@g
dugina	EZEN×DUN3@g
dugina2	EZEN×DUN3@g@g
dugu	HI
dugud	DUGUD
dugud2?	MI
duguda	DUGUD
dugux(DUGUD)	DUGUD
dugx(BI)	BI
dugx(|ŠEŠ.IB|)	ŠEŠ.IB
duh	GABA
duk	DUG
duk2	TUK
duka	DUG
dukudx(DUGUD)	DUGUD
dul	U.TUG2
dul10	BU
dul2	LAGAB×U
dul3	SAG@g
dul4	DUN4
dul5	TUG2
dul6	LAGAR@g
dul7	SAG
dul8	DIB
dul9	UR@s
dullux(|HA.NAGAR.BU|)	HA.NAGAR.BU
dulu	ŠU.BU
dulx(DU)	DU
dulx(DUN3)	DUN3
dulx(UR)	UR
dulx(|UR×A|)	UR×A
dum	TUM
dum3?	DAM
dum4	DIM
dumgal	ŠIM×A
dumu	TUR
dumu-gi7	TUR.EŠ2
dumx(TUR)	TUR
dun	DUN
dun3	DUN3
dun4	DUN4
dun5	BUR2
dun6	KAL
duna	DUN
dunda	PA.UZU
dunga	SAG
dunga2	LUL
dungax(|IM.SI.A|)	IM.SI.A
dungu	IM.SI.A
dunx(|KA×KID|)	KA×KID
dunx(|KA×SA|)	KA×SA
dup	DUB
dup2	DUB2
dupsik	IL2
duq	DUG
dur	GU2×KAK
dur10	ŠEN
dur11	TU
dur2	DUR2
dur3	ANŠE.ARAD
dur4	GIŠ%GIŠ
dur5	A
dur6	PA
dur7?	BU
dur8	EZEN×BAD
dur9	DUN
durah	DARA3
durahx(DARA4)	DARA4
durba	MA@g
durgul	MA2.MUG
duri?	NU11
durix(|KA×UŠ|)	KA×UŠ
durme	SAG.EZEN
duru2	DUR2
duru3	ANŠE.ARAD
duru4	GIŠ%GIŠ
duru5	A
duru6?	PA
duru9	DUN
durum	EZEN×BAD
durum2	DUR2
durum4	GIŠ%GIŠ
durun	DUR2
durun3	ŠU.LAGAB.NA
duruna	DUR2
duruna2	LAGAB×IM
duruna3	ŠU.LAGAB.NA
duruna4	LAGAB×GAR
durunax(|KU.KU|)	KU.KU
durungal	UD.NUN
durunx(|KU.KU|)	KU.KU
durunx(|ŠU.GAN2@t|)	ŠU.GAN2@t
durux?(|KU.GIŠ%GIŠ|)	KU.GIŠ%GIŠ
durx(|ARAD.ANŠE|)	ARAD.ANŠE
dusi	IL2
dusi2	ANŠE.IGI.EŠ2
dussa2	ANŠE.IGI.EŠ2
dussu	IL2
dusu	IL2
dusu2	ANŠE.IGI.EŠ2
dusux(|ANŠE.IGI.DIB|)	ANŠE.IGI.DIB
duttu	TUK.TUK
dux(HUB2)	HUB2
dux(LU2)	LU2
dux(|ŠEŠ.IB|)	ŠEŠ.IB
dux?(DI)	DI
duš	KU
duš2	DIŠ
duţu	KA.KA
dūru	EZEN×BAD.AN
e	E
e'	ALEPH
e'2?	HI×NUN
e'3	E2
e'ella	GA2×EL+LA
e'i	E2.A
e'u	E2.A
e10	NAGAR
e11	LAGAR@g.DU
e12	LAGAR@g.DU@s
e13?	SAL.KU
e2	E2
e2-gar6	E2.NUN
e3	UD.DU
e4	A
e5	SAL.TUG2
e6	SU&SU
e6-a	SU&SU.A
e7	KA
e8	UD
ea	A
eazag?	GA2×KU3+AN
eb	IB
eb2	TUM
ebeh	EN.TI
ebih	EN.TI
ebih2	EŠ2.MAH
ebir	DUG
ebir3	A
ebir4	GA
ebirx(BI)	BI
ebla	A.TAR.A.AN
ebur	EN×GAN2@t
eburra?	GA2×BAR+RA
eburux(|EN×GAN2@t|)	EN×GAN2@t
ed	A2
ed2	UD.DU
ed3	LAGAR@g.DU
ed4	LAGAR@g.DU@s
edakua	GA2×A+DA+HA
edakua2	LAGAB×A+DA+HA
edakuax(|E2×A+HA+DA|)	E2×A+HA+DA
edakuax(|GA2×A+HA|)	GA2×A+HA
edamu	A.TUR
edax(|UD.DU|)	UD.DU
eden	EDIN
edena	EDIN
edi	GA2×DI
edim?	BAD
edimx(EDIN)	EDIN
edin	EDIN
edina	EDIN
edur	A×A
eduru	A×A
edurux(|E2.A|)	E2.A
eg	IG
eg2	E
eg3	NINDA2×NE
ega	A.MI.A
ega2	NUN%NUN.LAGAR&LAGAR
egar	E2.SIG4
egara	GA2×GAR
egarax(|E2×GAR|)	E2×GAR
ege	EŠ2
ege2	SAL.EŠ2
eger	EGIR
eger2	EŠ2
eger3	SAL.EŠ2
eger4	TUM
egera	EGIR
egi	EŠ2
egi2	SAL.EŠ2
egia	GA2×GI4
egir	EGIR
egir2	EŠ2
egir3	SAL.EŠ2
egir4	TUM
egir5	LUM
egir6?	SIG4
egirsu	GA2×GIR2+SU
eh	HI×NUN
eh2	ALEPH
eh3	KU.KU
ehalla	GA2×HAL+LA
ehe	A2.UD.DU
ehehhe	KU.KU.KU
ehi	A2.UD.DU
ehili	GA2×HI+LI
ehx(|KU.KU.KU|)	KU.KU.KU
ek	IG
eki	E
el	EL
el2	IL
el3	AN
el4	IL×GAN2@t
ela	A.KAL
elal	ŠID×A
elal2	ŠID
elam	NIM
elama	NIM
elamkuš	LAGAB×IM
elamkuš2	LAGAB×LU
elamkuš3	LAGAB×HA
elamkuš4	LAGAB×A
elamkušx(|LAGAB×IM+LU|)	LAGAB×IM+LU
elamu	NIM
ele	U.KA
ele2	EL
eli	U.KA
elilla	GA2×KID+LAL
ella	A.KAL
ella2	LAGAB
ellag	LAGAB
ellag2	HI×ŠE
ellamkuš	LAGAB×IM
ellamkuš2	LAGAB×LU
ellamkuš3	LAGAB×HA
ellamkuš4	LAGAB×A
ellamkušx(|LAGAB×GAR|)	LAGAB×GAR
ellamkušx(|LAGAB×IM+HA|)	LAGAB×IM+HA
ellamkušx(|LAGAB×IM+LU|)	LAGAB×IM+LU
ellamx(|HI×ŠE|)	HI×ŠE
ellandu	SA.HI×ŠE.KAK
ellat	KASKAL.KUR
ellaĝ	LAGAB
ellaĝ2	HI×ŠE
ellil	EN.KID
em	IM
em3	NINDA2×NE
em4	KA×ME
emaš	MAŠ.X
eme	KA×ME
eme2	UM.ME
eme3	SAL.ANŠE
eme4	GA2×AN
eme4-du2	GA2×AN.TU
eme4-e4-du2	GA2×AN.A.TU
eme5	SAL.HUB2
eme6	ANŠE.SAL
eme7	SAL.AL
eme8	GA2×SAL
emeda	UM.ME
emeda3	UM×ME+DA
emedu	GA2×AN.TU
emedu2	GA2×AN.A.TU
emedub	GA2×DUB
emedub2	GA2×ŠID
emengi	KA×ME+GI
emerah	SAL.HUB2
emerahx(|UD.SAL.HUB2|)	UD.SAL.HUB2
emesig	KA×SIG
emex(KA)	KA
emex(|E2×SAL|)	E2×SAL
emex(|KA×GIR2|)	KA×GIR2
emex(|SAL.EN|)	SAL.EN
emex-gir2(|KA×GIR2|)	KA×GIR2
emezi	SAL.LAGAR
emezix(|SAL.LAGAB|)	SAL.LAGAB
emeš	SAL.LAGAR
emeš2	NE×UD
emma	KA×UD
emma2	KA×A
emmen	KA×UD
emmen2	KA×A
emmin	KA×UD
emmin2	KA×A
emuš	A×MUŠ
emx(A)	A
en	EN
en-lil2	EN.KID
en2	ŠU2.AN
en3	LI
en4	KA
en5	PA.TE
en6	IN
en7	ZAG
en8	ŠA
ena	EN
enaqa	NI.UD.IM
enbir	LU2@LU2
endib	EN.ME.MU
endibdim	HI×AŠ2
endub	EN.ME.MU
endur	PA
enegir	IM
enegir3	EN.DIM2.GIG
enem	KA
engar	APIN
engara	APIN
engarx(|KI.KA.LU2|)	KI.KA.LU2
engiz	EN.ME.GI
engiz2	EN×ME.GI
engizx(|EN.GI|)	EN.GI
engur	LAGAB×HAL
engurx(|LAGAB×A|)	LAGAB×A
eni	EN
enigin	A.LAGAB.LAGAB
enim	KA
enim2	NIM
enkar	EN×GAN2@t
enkara	EN×GAN2@t
enku	ZAG.HA
enkud	ZAG.HA
enkum	EN.PAP.IGI@g.NUN.ME.EZEN×KASKAL
enkux(|HA.ZAG|)	HA.ZAG
enme	EN×ME
enmen	KA×UD
enmen2	KA×A
enna	NI.UD.EN
ennigi2	EN.NUNUZ.DIM2
ennin	MUŠ3
ensag	PA.TE.SI
ensi	EN.ME.LI
ensi2	PA.TE.SI
ensi3	EN×ME
ensik	PA.TE.SI
ensix(|GAR.PA.TE.SI|)	GAR.PA.TE.SI
ensix(|PA.TE.SI.GAR|)	PA.TE.SI.GAR
enten	NE×A
entena	NE×A
enu	EN
enx(|NE.GI|)	NE.GI
enšab	NU11
enšada	PA.TUG2
enšadu	PA.TUG2
ep	IB
ep2	TUM
epig	SIG
epig2?	DUG
epir	DUG
epir2	BI
epir3	A
epir4	GA
eq	IG
eqlu	GAN2
er	IR
er10?	DU
er13	LU2×EŠ2@t
er2	A.IGI
er3	ARAD
er4	URU
er6	A×IGI
er9	GIR3
era2	A.IGI
era3?	GA2×ME+EN
era4?	GA2×PA
era?	ARAD.RA
erad?	ARAD
erarimx(|URU×UD|)	URU×UD
erba	LIMMU2
erbura	TAK4
ere	URU
ere14	IR
erem	ERIN2
eren	EREN
eren2	ERIN2
eren8	UR2×HA
erena	EREN
erena2	ERIN2
erex(|LU2×EŠ2|)	LU2×EŠ2
erex(|LU2×ŠU|)	LU2×ŠU
ereš	SAL.TUG2
ereš2	NAGA
ereš3	IR
ereš4	APIN
ereš5	GAL.AN.ZU
erešu	IR
eri	URU
eri11	AB@g
eri12	AB
eri13	LU2×EŠ2@t
eri14	IR
eri15?	GA2×ME+EN
eri16?	GA2×PA
eri3	ARAD
erib	AŠGAB
eribura	NUN%NUN
eribx(|A.EDIN|)	A.EDIN
eribx(|SAL.UD|)	SAL.UD
erida	NUN
erida2	PA.ŠA6
eridu	NUN
eridug	NUN
eriduga	NUN
erigal	AB×GAL
erim	ERIN2
erim2	NE.RU
erim3	URU×GAR
erim4	GA2×UD
erim5	AB@g
erim6	URU×UD
erim7	UR2×HA
erima2	NE.RU
erimmax(|URU×GAR|)	URU×GAR
erimx(|AB×U+U+U|)	AB×U+U+U
erin	EREN
erin2	ERIN2
erin3	URU×GAR
erin4	GA2×UD
erin5	AB@g
erin6	URU×UD
erin7	NE.RU
erin9	UR2×HA
erina	EREN
erina2	ERIN2
erina8	MUŠ%MUŠ.A.NA
erix(|MAŠ.X|)	MAŠ.X
erix(|URU×UD|)	URU×UD
eriš	SAL.TUG2
eriš2	NAGA
eriš4	APIN
eriš6	HI×BAD
eriš7	KAM2
erištix(|GAL.ZU|)	GAL.ZU
eru	ARAD
eru2	SAG.SAL
eru3	SAG×SAL
eru4	A.EDIN
eru5	EDIN
erua	A.EDIN
erua2	EDIN
erum	ARAD
erum2	SAG.SAL
erum3	SAG×SAL
erum4	A.EDIN
erx(|DU.DU|)	DU.DU
erx(|LU2×EŠ2|)	LU2×EŠ2
erx(|LU2×ŠU|)	LU2×ŠU
erşetu	KI
es	GIŠ
es2	U.U.U
es3	AB
es5	IŠ
esa3	AB
esag	A×SAG
esag2	GA2×ŠE
esagtur	GA2×ŠE+TUR
esagx(|E2.ŠE|)	E2.ŠE
esagx(|E2×ŠE|)	E2×ŠE
esaĝ	A×SAG
esaĝ2	GA2×ŠE
esaĝtur	GA2×ŠE+TUR
esen	EZEN
eseš	A.IGI
esi	KAL
esibir	GA2×EN×GAN2@t
esig	KAL
esikilla	GA2×EL+LA
esin	EZEN
esir	A.LAGAB×KUL
esir2	LAGAB×KUL
esir3	KAD5.KAD5
esir4	GI%GI
esir5	GI4%GI4
esirha	LAGAB×KUL+HI+A
esirhia	LAGAB×KUL+HI+A
esirx(LAK171@s)	LAK171@s
esirx(|KAD5&KAD5|)	KAD5&KAD5
esiš3	A.IGI
essad	ZAG.HA
essadu	AB.HA.ZAG.GABA.HU
et	A2
etam	GA2×UD
etutumx(|GA2×BAD|)	GA2×BAD
eurre	E2.KI.SUM.GA
ew	PI
ex(PI)	PI
ex(|LAGAB×HAL|)	LAGAB×HAL
ex(|LUGAL@LUGAL|)	LUGAL@LUGAL
ez	GIŠ
ez3	AB
eze	LU
ezem	EZEN
ezema	EZEN
ezen	EZEN
ezen4	EZEN×ŠE
ezena	EZEN
ezennax(|ŠE.ŠE.NUN&NUN|)	ŠE.ŠE.NUN&NUN
ezim2	ŠE.ŠE.NUN&NUN
ezin	EZEN
ezin2	ŠE.ŠE.NUN&NUN
ezina2	ŠE.ŠE.NUN&NUN
ezinax(|(ŠE.NUN&NUN)×TAK4|)	(ŠE.NUN&NUN)×TAK4
ezinu2	ŠE.ŠE.NUN&NUN
ezinu3	ŠE.NUN&NUN
ezinux(|(ŠE.NUN&NUN)×TAK4|)	(ŠE.NUN&NUN)×TAK4
ezinux(|GIŠ×TAK4|)	GIŠ×TAK4
ezix(|SAL.LAGAR|)	SAL.LAGAR
eĝ	IG
eĝ3	NINDA2×NE
eĝara	GA2×GAR
eĝarax(|E2×GAR|)	E2×GAR
eĝer	EGIR
eĝera	EGIR
eĝir	EGIR
eĝir5	LUM
eĝir6?	MURGU2
eş	GIŠ
eş3	AB
eš	U.U.U
eš10	A
eš11?	RI
eš12	NE×UD
eš13	NE×A
eš14	EL
eš15	IŠ
eš16	AŠ&AŠ&AŠ
eš17	ME.U.U.U
eš18	AŠ
eš19	GIŠ
eš2	EŠ2
eš20	AŠ
eš21	TAB.AŠ
eš22	LAM×KUR
eš3	AB
eš4	DIŠ
eš5	DIŠ.DIŠ.DIŠ
eš6	AŠ.AŠ.AŠ
eš7	BAD
eš8	KASKAL
eš9	A.IGI
eša	A.ŠE.NUN&NUN
eša2	U.U.U
eša3	AB
eša5	DIŠ.DIŠ.DIŠ
ešax(KAL)	KAL
ešda	ŠITA2
ešda2	ŠITA.GIŠ.TUG2
ešda3	ŠITA
ešdax(KU7)	KU7
eše	U.U.U
eše2	EŠ2
eše3	IDIM
eše4	A.ŠE.NUN&NUN
ešela	LU2×EŠ2.LAL
ešelal	LU2×EŠ2.LAL
ešemen	KI.E.NE.DI
ešemen2	KI.E.NE.DI.AN.MUŠ3
ešemen3	EŠ2.HUL2
ešemen4	AB×IMIN
ešemen5	BI
ešemin	KI.E.NE.DI
ešemin2	KI.E.NE.DI.AN.MUŠ3
ešemin3	EŠ2.HUL2
ešemin4	AB×IMIN
ešemin5	BI
ešer	A.LAGAB×KUL
ešex(AB)	AB
ešgal	AB×GAL
ešgar	AŠ2.GAR3
ešgarx(|U.EN×GAN2@t|)	U.EN×GAN2@t
ešgiri	U.EN×GAN2@t
ešgiri2	EN×GAN2@t
eškiri	U.EN×GAN2@t
eškiri2	EN×GAN2@t
ešlug	LU2×LAGAB
ešqa	KU7
ešsad	ZAG.HA
ešsadu	AB.HA.ZAG.GABA.HU
eštax(|ŠITA.GIŠ.TUG2|)	ŠITA.GIŠ.TUG2
eštub	GUD
ešux(|LAM×KUR|)	LAM×KUR
ešx(LAM)	LAM
ešša2?	ŠU2
ešša3?	GI
eššaba	DIC.DIC.DIC.U.U
eššad	ZAG.HA
eššana	DIC.DIC.DIC.U.U
eššeb	KI.IB
eššu2	AN
eţ	A2
eţlu	KAL
eţutu	GA2×BAD
f	SAL
ga	GA
ga'azag?	GA2×KU3+AN
ga-ša-an-an-na	MUŠ3
ga11?	HI×AŠ2
ga12?	MI
ga14	KA
ga15?	GABA
ga2	GA2
ga3?	GAN2
ga4	GAR
ga5	SILA3
ga6	IL2
ga7	IG
ga8	GI4
gab	GABA
gab2	KAB
gab3	KA×A
gaba	GABA
gaba2	KAB
gabar	PA.DAG.KISIM5×KAK
gabar2	DAG.KISIM5×KAK
gabrax(|DA.UŠ|)	DA.UŠ
gabu2	KAB
gaburra	GA2×BUR+RA
gaburra?	GA2×BAR+RA
gabux(|KAB.BU|)	KAB.BU
gad	GAD
gada	GAD
gadibdim	HI×AŠ2
gadma	GUD
gadu	GAD
gadub	GA2×DUB
gadx(LU3)	LU3
gaeš	GA.KASKAL
gaeš2	KASKAL.GA
gag	KAK
gaga	GA2×IGI@g
gagal	IG
gagalam	GALAM.GALAM
gagar	KI
gagax(|NUN.LAGAR×GAR|)	NUN.LAGAR×GAR
gagazu?	GAL.ZU
gaggim	MUG
gagi	GA2×GI4
gagi2	GA2×GI
gagia	GA2×GI4
gagia2	GA2×GI
gagig	GA2×MI
gagigx(|E2×MI|)	E2×MI
gagim	MUG
gagirsu	GA2×GIR2+SU
gagri?	GI4
gagx(|ZA.GUL|)	ZA.GUL
gahalla	GA2×HAL+LA
gahili	GA2×HI+LI
gaiš	GA.KASKAL
gaiš2	KASKAL.GA
gak	KAK
gakim	MUG
gakişşu	GA2×AB2@t+TAB
gakkul	U.DIM×ŠE
gakkul2	DIM×ŠE
gakkul3	U.DIM
gal	GAL
gal-di	GAL.DI
gal-zu	GAL.ZU
gal10	LU2.DIŠ
gal2	IG
gal3?	URU×MIN
gal4	SAL
gal4-la	SAL.LA
gal5	TE
gal5-la	TE.LAL
gal8	UD
gal9	KAL
gala	UŠ.KU
gala10	LU2.DIŠ
gala11	LAGAB×DAR
gala2	SAL.LA
gala3	LAGAB×U
gala4	LAGAB×AL
gala5	LAGAB×KI
gala6	ŠU2
gala7	IG
gala8	GAL
galam	GALAM
galax(|ARAD.KU|)	ARAD.KU
galax(|UŠ×KU|)	UŠ×KU
gale	GAL
galga	GA2×GAR
galgax(|GA2×IGI@g|)	GA2×IGI@g
galgax(|NUN.LAGAR×GAR|)	NUN.LAGAR×GAR
galilla	GA2×KID+LAL
galla	TE.LAL
galla2	SAL.LA
gallagalx(|GAL.TE.LAL|)	GAL.TE.LAL
gallax(TE)	TE
galti	GAL.DI
galu	TE.LAL
galx(ME)	ME
galx(|UŠ.KU|)	UŠ.KU
gam	GAM
gam2	HI×BAD
gam3	KAM4
gam4	GAN
gama2?	HI×BAD
gamar	NI
gambi?	SAL.UŠ.DI
gambix(SAL)	SAL
gaml	KU7
gammu?	SAL.UŠ.DI
gamu	SAL.UŠ.DI
gamun	DIN.ŠE.NUN&NUN
gamun2	ŠE.NUN&NUN
gamurx(LAK490)	LAK490
gamx(LUM)	LUM
gan	GAN
gan2	GAN2
gan3	DU@s.A
gan7	GAM
gana	GAN
gana2	GAN2
gana3	DU@s.A
gana4	LAGAB×GUD+GUD
gana5	LAGAB×GUD
gana6	DARA4
ganam4	LAGAB×GUD+GUD
ganam5	LAGAB×GUD
ganam6	DARA4
ganamx(|SIK2.AŠ|)	SIK2.AŠ
ganax(|KA×MI|)	KA×MI
ganax(|SIK2.AŠ|)	SIK2.AŠ
ganba	KI.LAM
gansis	TA@g
gansisx(|TA×MI|)	TA×MI
ganu	U.EN×GAN2@t
ganun	GA2×NUN
ganzer	IGI.KUR.ZA
ganzer2	NE.SI.A
ganzer3	IGI.KUR
ganzerx(TA@g)	TA@g
ganzir	IGI.KUR.ZA
ganzir2	NE.SI.A
ganzir3	IGI.KUR
gap	GABA
gap2	KAB
gapi?	GAR.GA2×A+IGI
gar	GAR
gar10	GA.NI
gar11	GA.A
gar12	GA.DIŠ
gar13	TE@g
gar14	TE.A
gar19	GAN2@t
gar2	GA@g
gar3	GAR3
gar4	GUD
gar5	LU3
gar6	NUN
gar7	MAR
gar8	SIG4
gar9	GA
gara	GAR
gara10	GA.NI
gara11	GA.A
gara2	GA@g
gara3	GAR3
gara4	GUD
gara6	NUN
gara8	SIG4
gara9	GA
garadin	(ŠE.NUN&NUN)&(ŠE.NUN&NUN).GAD&GAD.GAR&GAR
garadin10	U&U.PA&PA.GAR&GAR
garadin2	ŠE&ŠE.GAD&GAD.GAR&GAR
garadin3	ŠE&ŠE.TAB&TAB.GAR&GAR
garadin4	(ŠE.NUN&NUN)&(ŠE.NUN&NUN).LAGAB.LAGAB
garadin5?	LAGAB.LAGAB
garadin6?	(ŠE.NUN&NUN)&(ŠE.NUN&NUN)
garadin7	ŠE&ŠE.PA&PA.GAR&GAR
garadin8	ŠE&ŠE.GAR&GAR
garadin9	U&U.SUR&SUR
garak	GAN2@t
garak5	GAR
garax(|GA.KASKAL|)	GA.KASKAL
garaš	GA2×HUB2
garaš2	KI.KAL×BAD
garaš3	GA.KASKAL
garaš4	KASKAL.GA
garaš5	KI.KAL
garašax(|KI.BAD|)	KI.BAD
garašx(|KI.KAL.BAD.IDIM|)	KI.KAL.BAD.IDIM
garig2?	ZUM
garim	LAGAB×KU3
garim2	DAG.KISIM5×AMAR
garimx(|SAL.LAGAR|)	SAL.LAGAR
garin	LAGAB×KU3
garinx(|GA2×AN.ŠIM×GAR|)	GA2×AN.ŠIM×GAR
garinx(|SAL.LAGAR|)	SAL.LAGAR
garu	UD.KUŠU2
garx(GIR2)	GIR2
garx(NUN@t)	NUN@t
garx(|GA.GA|)	GA.GA
garza	PA.AN
garza2	PA.LUGAL
garzu	PA.AN
gas	GUM×ŠE
gas2?	GUM
gasa	KA×GIŠ%GIŠ
gasax(ŠIR)	ŠIR
gasibir	GA2×EN×GAN2@t
gasikilla	GA2×EL+LA
gasx(|NU11.BUR|)	NU11.BUR
gat	GAD
gat2	KAD2
gat3	KAD3
gax(GALAM)	GALAM
gax(ME)	ME
gayayu	LAGAB×GUD+GUD
gayayux(|SIK2.AŠ|)	SIK2.AŠ
gaz	GUM×ŠE
gaz2	GUM
gaz3	DUB×EŠ2
gaza	GUM×ŠE
gaza3	KA×GIŠ%GIŠ
gazag?	GA2×KU3+AN
gazax(|GA2×PA|)	GA2×PA
gazi	GA2×PA
gazi2	GA2×SUM
gazi3	GA2×SAR
gazibu	BU
gazigal	GA2×AŠ2+GAL
gazimbi	BU
gazinbi	BU
gazinbu	BU
gazum	SAL.LAGAB×AŠ2
gazum2	ZUM
gazumx(|ZUM.LAGAB|)	ZUM.LAGAB
gaş	GUM×ŠE
gaš	BI
gašam	NUN.ME.TAG
gašamx(|ME.NUN.TAG|)	ME.NUN.TAG
gašan	GAŠAN
gašmu	AŠ&AŠ.TUG2&TUG2.TUG2&TUG2.PAP
gaššu	NUN.ME.TAG
ge	GI
ge10	NE@s
ge11	DUN3@g
ge12	SAL.KUR
ge13?	DU
ge14	U
ge15	AŠ
ge16	GI%GI
ge17	GIG
ge18	DIM2
ge19	PEŠ2
ge2	KID
ge20	GA
ge21?	KUR
ge22	AŠ@k
ge23	AŠ@z
ge24	ARAD×KUR
ge26	GA2
ge28	DAG.KISIM5×NE
ge3	DIŠ
ge4	GI4
ge5	KI
ge6	MI
ge7	EŠ2
ge8	IGI
ge9	NE
gedim	GIDIM
gel	GI%GI
gele3	KA×LI
geli3	KA×LI
geltan	PI
gem	DIM2
gem3	SAL.KUR
geme2	SAL.KUR
geme3	ARAD×KUR
gen	DU
gen3	KUR
gen6	GI
gen7	DIM2
gena	TUR.DIŠ
genan	TUR.DIŠ
genna	TUR.DIŠ
ger15	EŠ2
ger3	GIR3
gereš	HI×ŠE
gereš3	ARAD×KUR
gex(ME)	ME
gez	GIŠ
geš	GIŠ
geš-tin	GIŠ.DIN
geš2	DIŠ
geš3	UŠ
geš4	AŠ
gešba	RU
gešbu	RU
gešbu2	ŠU.PAP.PAP
gešbun	KI.BI.GAR
gešbun2	KI.BI
gešbunx(|GIŠ.KI.BI|)	GIŠ.KI.BI
gešburx(U)	U
gešbux?(|GIŠ.RU|)	GIŠ.RU
gešdu	PI
gešdu2	GIŠ.TUG2.PI
gešdu3	GIŠ.PI.TUG2
gešdu4	IGI.DU
gešhar	GIŠ×BAD
gešhur	KAD4
gešimmar	ŠA6
geškad	KAD4
geškadx?(TUM)	TUM
gešnimbar	ŠA6
gešnu	NU11
gešnu2	NU11.IR
gešpax?(|GIŠ.RU|)	GIŠ.RU
gešpu2	ŠU.PAP.PAP
gešpux?(|GIŠ.RU|)	GIŠ.RU
gešta	DIŠ
geštae	ZA×4×KUR
geštaex(|ZA.KUR|)	ZA.KUR
geštara	PA
geštin	GEŠTIN
geština	GEŠTIN
geštu	PI
geštu2	GIŠ.TUG2.PI
geštu3	GIŠ.PI.TUG2
geštu4	IGI.DU
geštug	PI
geštug2	GIŠ.TUG2.PI
geštug3	GIŠ.PI.TUG2
geštunux(PI)	PI
geštux(|IGI.EŠ2.DU|)	IGI.EŠ2.DU
gešu	DIŠ
gešx(|U.U|)	U.U
gešx(|UŠ×KUR|)	UŠ×KUR
gi	GI
gi10	NE@s
gi11	DUN3@g
gi12	SAL.KUR
gi16	GI%GI
gi17	GIG
gi18	DIM2
gi2	KID
gi25?	DUGUD
gi27	BU
gi3	DIŠ
gi4	GI4
gi5	KI
gi6	MI
gi7	EŠ2
gi8	IGI
gi9	NE
gib	GI%GI
gib2	GIŠ%GIŠ
gib3	GIG
gibil	NE@s
gibil2	ŠU2.AŠ2
gibil3	KI.NE
gibil4	NE
gibil5	GALAM.GALAM
gibil6	NE.GI
gibil7	ŠU2.AN
gibila	NE@s
gibilx(|GIŠ.NE@s|)	GIŠ.NE@s
gibir	ŠU2.AŠ2
gibir2	ŠU2.AN
gibiru	U
giburu	U
gid	KID
gid2	BU
gid3?	SA
gid4?	GAD
gid6	TAK4
gida2	BU
gida4	GAD
gidar	PA
gidax?(|E2×BAD|)	E2×BAD
gidešta?	GAR.ŠUŠANA.SILA3
gideštax?(|GAR.KINGUSILI.SILA3|)	GAR.KINGUSILI.SILA3
gideštax?(|GAR.ŠANABI.SILA3|)	GAR.ŠANABI.SILA3
gidi3	BU
gidi6	UD.GAN
gidim	GIDIM
gidim2	MAŠ.U
gidim3	BU
gidim4	UDUG
gidim7?	GUD
gidirx(PA)	PA
gidlam	SAL.UŠ.DAM
gidlam2	UŠ.DAM
gidlam3	UŠ.SAL.DAM
gidlam4	SAL.UŠ
gidri	PA
gidru	PA
gidx(|DU.DU|)	DU.DU
gig	GIG
gig2	MI
gig3?	GI%GI
gig4	DUN3@g
gigam	LU2@LU2
gigamx(|LU2.LU2|)	LU2.LU2
giggi	MI
gigi	GI4%GI4
gigi2	MI
gigir	LAGAB×BAD
gigir2	LAGAB×U
gigir3	LAGAB×LIŠ
gigir4?	LAGAR@g.DU
gigira	LAGAB×BAD
gigira2	LAGAB×U
gigirum	GAM.GAM
gigirx(|LAGAB×TIL|)	LAGAB×TIL
gigri	DU@g.DU@g
gigri2	DU@s.DU@s
giguru	U
giguru2	MAŠ.U
giguru3	KA×ŠID
gikki	MI
gil	GI%GI
gil2	LAGAB
gil3	IL2
gilgames	GIŠ.DUN3@g.MAŠ
gilgames3	GIŠ.NE.GA.MES
gilgameš	GIŠ.DUN3@g.MAŠ
gilgameš2	GIŠ.NE@s.GA.ME.U.U.U
gilgameš3	GIŠ.NE.GA.MES
gili	GI%GI
gili2	LAGAB
gili3	KA×LI
gilib3	KA×LI
gilib4	KA×RU
gilibx(|GI%GI|)	GI%GI
gilili	PEŠ2
gilim	GI%GI
gilim2	PEŠ2
gilin	PEŠ2
gillim	GI%GI
gilugu?	LAGAB×HAL
gim	DIM2
gim2	DUN3@g
gim3	SAL.KUR
gim4	DU@s
gim5?	DU@g
gim6	DU
gim7	BU
gim8?	GAD.TAK4.GIŠ
gimi	DIM2
gin	DU
gin2	DUN3@g
gin3	KUR
gin4	ZI&ZI.LAGAB
gin5	SAL.KUR
gin6	GI
gin7	DIM2
gin8	HI×AŠ2
gina	TUR.DIŠ
gina2	DUN3@g
gina3	KUR
ginan	TUR.DIŠ
ginax(DU)	DU
gingira?	KISIM5&KISIM5
ginna	TUR.DIŠ
ginx(|A.ZI&ZI|)	A.ZI&ZI
ginx(|ZI&ZI.A|)	ZI&ZI.A
ginx(|ZI&ZI.EŠ2|)	ZI&ZI.EŠ2
gip2	GIŠ%GIŠ
gir	HA@g
gir10	NE
gir11	KEŠ2
gir12	IN
gir13	ŠID
gir14	HA
gir15	EŠ2
gir16	GIR3×GAN2@t
gir17	KA
gir18	NE.GI
gir2	GIR2
gir3	GIR3
gir4	U.AD
gir5	DU@s
gir6	DU@g
gir7	DU
gir8	LAGAB
gir9	AB2×ŠA3
gira	U.MAŠ.KAB
gira2	GIŠ.BAR
gira3	NE.GI
giraba	AB
girabax(|AB.HA@g|)	AB.HA@g
girah	ŠU.DIM2
girenx(LAGAB)	LAGAB
gireš	HI×ŠE
gireš2	GURUŠ
giri	HA@g
giri11	KEŠ2
giri16	GIR3×GAN2@t
giri17	KA
giri19	ŠU.LU2
giri2	GIR2
giri20	ŠU.AN
giri21	ŠU.LUGAL
giri3	GIR3
giri5	DU@s
giri6	DU@g
giri8	LAGAB
girid	KEŠ2
girid2	GIR3×GAN2@t
girim	LAGAB
girim2	DU@s
girim3	A.HA.TAR.KAK
girin	LAGAB
girix(LU2)	LU2
girix(|GIŠ.LU2|)	GIŠ.LU2
girix(|GIŠ.ŠU.LU2|)	GIŠ.ŠU.LU2
girix(|KA×LI|)	KA×LI
giriš	HI×ŠE
giriš2	GURUŠ
giriš3	ARAD×KUR
girišx(|HI×NUN|)	HI×NUN
girra	NE.GI
girrix(GAN2)	GAN2
girrix(|GAN2%GAN2|)	GAN2%GAN2
girrix(|GIŠ%GIŠ|)	GIŠ%GIŠ
giru3	GIR3
girum	GAM
girx(EDIN)	EDIN
girx(|AB2.ŠA3|)	AB2.ŠA3
girx(|AB2×TAK4|)	AB2×TAK4
girx(|GIR3.ZA@t|)	GIR3.ZA@t
girx(|U.EN×GAN2@t|)	U.EN×GAN2@t
girza	PA.LUGAL
gis	GIŠ
gisbun	KI.AŠ.AŠ
giskim	IGI.DUB
gissu	GIŠ.MI
git	KID
git2	BU
gitag	GI
gitlam	SAL.UŠ.DAM
gitlam2	UŠ.DAM
gitlam3	UŠ.SAL.DAM
gitlam4	SAL.UŠ
giz	GIŠ
gizal2	GIŠ.TUG2.PI.ŠIR.SILA3
gizbun	KI.BI.GAR
gizkim	IGI.DUB
gizzal	GIŠ.TUG2.PI.ŠIR.SILA3
gizzal2	NU11.SILA3
gizzu	GIŠ.MI
giĝ4	DUN3@g
giş?	GIŠ
giš	GIŠ
giš2	DIŠ
giš3	UŠ
giša	GIŠ
gišbar	AL×GIŠ
gišbun	KI.BI.GAR
gišdu	PI
gišdu2	GIŠ.TUG2.PI
gišdu3	GIŠ.PI.TUG2
gišgal	URU×MIN
gišha	ŠITA2
gišhar	GIŠ×BAD
gišhur	KAD4
gišhurx(LAK171@s)	LAK171@s
gišimmar	ŠA6
giškad	KAD4
giškadx(LAK171@s)	LAK171@s
giškadx?(TUM)	TUM
giškim	IGI.DUB
gišmaš	AL×GIŠ
gišnu	NU11
gišta'e	ZA×4×KUR
gišta'e2	ZA.KUR
gišta'i	ZA×4×KUR
gišta'i2	ZA.KUR
gištu	PI
gištu2	GIŠ.TUG2.PI
gištu3	GIŠ.PI.TUG2
gištug	PI
gištug2	GIŠ.TUG2.PI
gištug3	GIŠ.PI.TUG2
gištunux(PI)	PI
gišturu	PA
gišx(|U.U|)	U.U
gišzal	GIŠ.TUG2.PI.ŠIR.SILA3
giššir	EN×GAN2@t
giţ2	BU
gu	GU
gu10	MU
gu11?	GA
gu13?	HI×AŠ2
gu14	KI
gu15	LUM
gu16?	KA2
gu2	GU2
gu3	KA
gu4	GUD
gu5	KU
gu6?	KA×A
gu7	KA×GAR
gu8	GUM
gu9	KUL
guana	UZ3.KASKAL
gub	DU
gub2	LI
gub3	KAB
gub4	NI
gub5	KID
guba	DU
gubalaga	EZEN×LA
gublaga	EZEN×LA
gubu	DU
gubu3	KAB
gud	GUD
gud10	BALAG
gud2	SAG×UR
gud3	U2.KI.SUM.GA
gud4	TAR
gud5	GALAM
gud6	LUM
gud7	KU
gud8	LAGAB
gud9	ŠID
guda2	HI×NUN.ME
guda3	SAG×UR
guddax(|HI×NUN.ME|)	HI×NUN.ME
gudedde	KA×UMUM×PA
gudibdim	HI×AŠ2
gudibir	TAK4
gudibir2	KUR@KUR
gudiddi	KA×BALAG
gudma	GUD
gudu	GUD
gudu10	BALAG
gudu11	SUMAŠ.ME
gudu2	SAG×UR
gudu4	HI×NUN.ME
gudu5	ŠA3×ŠU2
gudug	HI×NUN.ME
gudug2	SUMAŠ.ME
gudux(|HI×NUN|)	HI×NUN
gudx(LU3)	LU3
gudx(TAK4)	TAK4
gudx?(|HI×NUN.ME|)	HI×NUN.ME
gueriši	GU2×SAL+TUG2
gug	ZA.GUL
gug2	LU3
gug3	GAR.LU3
gug4	ZI&ZI.LAGAB
gug5	LUGAL@LUGAL
gug6	KA.KAK
gugarid	GUD
guggal	HUL2
guggim	MUG
gugim	MUG
gugina	GAR.LU3
gugru	GAN2@t.GAN2@t
gugu2	EZEN×KASKAL×4
gugumu	LUM.LUM
gugx(|A.ZI&ZI|)	A.ZI&ZI
gugx(|ZI&ZI.A|)	ZI&ZI.A
gugx(|ZI&ZI.EŠ2|)	ZI&ZI.EŠ2
gugx(|ZI&ZI|)	ZI&ZI
guhšu	SIG4&SIG4.ŠU2
guhšu2	LUM&LUM.ŠU2
gukim	MUG
gukin	LAGAB×KIN
gukin2	HI×KIN
gukkal	HUL2
gukri	KA×GIŠ+SAR
gul	GUL
gul2	KUL
gul3	TE
gulla	TE.LAL
gulu	GUL
gum	GUM
gum2	LUM
gum2-gum2	LUM&LUM
gum2-gum2-kaš4	LUM&LUM.DU@s
gum2-gum2-šu2	LUM&LUM.ŠU2
gum3	NE
gum4	GAM
gumgum	LUM&LUM
gumgumšu	LUM&LUM.ŠU2
gumle	EZEN×IGI@g
gumu	LUM
gumx?(GU)	GU
gun	GU2.UN
gun2	GU2
gun3	DAR
gun4	AB@g
gun5	LUM
guna4	AB@g
gunin2	LAGAB×A
guninx(|LAGAB×GAR|)	LAGAB×GAR
gunni	KI.NE
gunu3	DAR
gunu4	AB@g
gunux(SI@g)	SI@g
gunux(|AB×U+U+U|)	AB×U+U+U
gunux(|HI×AŠ2|)	HI×AŠ2
gunx(|AB×U+U+U|)	AB×U+U+U
gunx(|AN.HU.MI.IM|)	AN.HU.MI.IM
gup	DU
gup2	LI
gup5	KID
guq	ZA.GUL
gur	GUR
gur10	KIN
gur11	GA
gur12	PAP
gur13	NI
gur14	HI×AŠ2
gur15	UR4
gur16	KUR
gur17	GIŠ@t
gur18	KA
gur19	NUN@t.KI
gur2	GAM
gur21	E.TUM
gur22	LAGAB×HAL
gur3	IL2
gur4	LAGAB
gur5	URU×GU
gur6	GAN2@t
gur7	GUR7
gur8	TE@g
gur9	NINDA2
gura	GUR
gura8	TE@g
gurdub	GA2×GI
gurdub2?	GA2×GI4
gurin	GURUN
gurinx(DUG)	DUG
gurinx(|BAD.IGI.BAD|)	BAD.IGI.BAD
gurinx(|IDIM&IDIM.BUR|)	IDIM&IDIM.BUR
gurinx(|IDIM&IDIM×4|)	IDIM&IDIM×4
gurinx(|IDIM×4|)	IDIM×4
gurinx(|TAB×4|)	TAB×4
guru	GUR
guru12	U
guru17	GIŠ@t
guru19	NUN@t.KI
guru2	GAM
guru20	GURUN
guru21	E.TUM
guru3	IL2
guru5	URU×GU
guru6	GAN2@t
guru7	GUR7
guru8	TE@g
gurud	NUN@t.KI
gurud2	LU2×KI
gurum	GAM
gurum2	IGI.ERIN2
gurum3	KA×GU
gurumx(GURUN)	GURUN
gurumx(|IGI.GAR|)	IGI.GAR
gurun	GURUN
gurun2	BAD.IGI.BAD
gurun3	LAGAB
gurun4	LAGAB×4
gurun5	IDIM×4
gurun7	DUG
gurun8	DIN
gurunx(|IDIM&IDIM.BUR|)	IDIM&IDIM.BUR
gurunx(|IDIM&IDIM×4|)	IDIM&IDIM×4
gurunx(|TAB×4|)	TAB×4
gurusa	KU7
gurux(ZI3)	ZI3
gurux(|E.TUM.GA2×NUN&NUN|)	E.TUM.GA2×NUN&NUN
gurux(|IGI.ERIN2|)	IGI.ERIN2
gurux(|LAGAB×4|)	LAGAB×4
guruš	GURUŠ
guruš2	KU7
guruš3	URU×GU
guruš4	TAG
gurušda	KU7
gurušta	KU7
gurušti	KU7
guruštix(|DI.X|)	DI.X
gurušx(UŠ)	UŠ
gurušx(|KA×KI|)	KA×KI
gurx(EDIN)	EDIN
gurx(GUD)	GUD
gurx(X)	X
gurx(ZI3)	ZI3
gurx(|KA×GU|)	KA×GU
gurx(|ŠE.KIN.KIN|)	ŠE.KIN.KIN
gurx(|ŠE.KIN|)	ŠE.KIN
gurx(|ŠE.ŠE.KIN|)	ŠE.ŠE.KIN
gutir	BU&BU.UN
gux(DAR)	DAR
gux(|KA×GU|)	KA×GU
guz	LUM
guz2	BU
guz3	KU
guza	KU.GAR
guzix(|KA×ZI|)	KA×ZI
guzza	KU.GAR
guš	SU
guškin	KU3.GI
gušur	GA2×NUN&NUN
gušur2	RAB.GAL
ha	HA
ha2	HI.A
ha3	U
ha4	HI
ha5	UD
ha6	HA@g
ha7	GA
ha8?	ŠITA2
hab	LAGAB
hab2	LAGAB×U
haba	LAGAB
habburudax(|ŠA3×BAD|)	ŠA3×BAD
habburudax(|ŠA3×U|)	ŠA3×U
habrud	KI×U
habrud2	KI×BAD
habrud3	ŠA3×BAD
habrud4	ŠA3×U
habruda	KI×U
habruda2	KI×BAD
habruda3	ŠA3×BAD
habruda4	ŠA3×U
had	PA
had2	UD
had3	ŠA6
had4	KAD4
hada2	UD
hadx(LAK171@s)	LAK171@s
hahad	UD.UD
hahhadx(|UD.UD|)	UD.UD
haia	NAGAR
hal	HAL
hal2	ZUM
hala	HAL
halba	MUŠ3×A+DI
halba2	ZA.MUŠ3.DI
halba3	ZA.MUŠ3@g.DI
halba4	LAL2.HAL
halba5	LAL2.URU×MIN
halba6	A.MUŠ3.DI
halbax(|A.MUŠ3×A.DI|)	A.MUŠ3×A.DI
halbax(|MUŠ3.DI|)	MUŠ3.DI
halbax(|MUŠ3×DI|)	MUŠ3×DI
halbax(|ZA.MUŠ3|)	ZA.MUŠ3
halbi	MUŠ3×A+DI
halbi2	ZA.MUŠ3.DI
halbi3	ZA.MUŠ3@g.DI
halbi4	LAL2.HAL
halbi5	LAL2.URU×MIN
halbi6	A.MUŠ3.DI
halbix(|A.MUŠ3×A.DI|)	A.MUŠ3×A.DI
halbix(|MUŠ3.DI|)	MUŠ3.DI
halbix(|MUŠ3×DI|)	MUŠ3×DI
halbu	MUŠ3×A+DI
halbu2	ZA.MUŠ3.DI
halbu3	ZA.MUŠ3@g.DI
halbu4	LAL2.HAL
halbu5	LAL2.URU×MIN
halbu6	A.MUŠ3.DI
halib	IGI.KUR
halpi	LAL2.URU×MIN
halpia	LAL2.URU×MIN
halpiax(|LAL2.HAL|)	LAL2.HAL
halpiax(|LAL2.URU×MIN|)	LAL2.URU×MIN
halpix(|LAL2.HAL|)	LAL2.HAL
halubba	GA2×HA+LU+EŠ2
hamanzer	PA.IB
hamanzerx(|SIK2.PA.IB|)	SIK2.PA.IB
hamanzirx(|SIK2.PA.IB|)	SIK2.PA.IB
hamun	NAGA@NAGA
hanburuda	KI×U
haniš	IDIM
haniš2	LUGAL
haniš3	PA
hanzalub	ŠA3.GI
hap	LAGAB
hap2	LAGAB×U
har	HI×AŠ2
har2	GUD
har3	LU2×LAGAB
hara	HI×AŠ2
hara2?	GUD
hara3	LU2×LAGAB
hara4	DAG.KISIM5×BI
hara5	DAG.KISIM5×U2+GIR2
harax(|DAG.KISIM5×GA|)	DAG.KISIM5×GA
harax(|DAG.KISIM5×LU+MAŠ2|)	DAG.KISIM5×LU+MAŠ2
harax(|NUNUZ.AB2×BI|)	NUNUZ.AB2×BI
harax(|NUNUZ.KISIM5×BI|)	NUNUZ.KISIM5×BI
haru4	DAG.KISIM5×BI
harub	DAG.KISIM5×U2+GIR2
harubx(|NUNUZ.AB2×U2|)	NUNUZ.AB2×U2
harx(|DAG.KISIM5×BI|)	DAG.KISIM5×BI
harx(|KI×U|)	KI×U
has	TAR
has2	PA
hax(NI)	NI
haya	NAGAR
haz	TAR
haz2	PA
hazabur	U2
haş	TAR
haş2	PA
haš	TAR
haš2	ZIG
haš3	UD
haš4	ZUM
hašhur	MA@g
haţ	PA
he	HI
he2	GAN
hegal	GA2×AN
henbur	KAK
henbur2	ŠE.KAK
henburx(|IGI.KAK|)	IGI.KAK
hendur	PA
henzer	IGI.DIM
henzir	IGI.DIM
her	KEŠ2
heš	UD
heš2	ZIG
heš5	LU2×GAN2@t
hi	HI
hi2	GAN
hibira	AL×HA
hibis	TUR.DIŠ
hibis2	AL×UŠ
hibiz	TUR.DIŠ
hibiz2	AL×UŠ
hilib	IGI.KUR
hilib2	NAGA
hilibu	E&E.NUN&NUN
hir	KEŠ2
hir2	HI×AŠ2
hirim	KI.KAL
hirin	KI.KAL
hirin2	KU7
hirinx(KWU318)	KWU318
hix(|SIG4&SIG4.ŠU2|)	SIG4&SIG4.ŠU2
hiš2	ZIG
hiš3	ERIN2
hiš4	HI.GIR3
hu	HU
hu2	TU
hu2?	KU4
hu3	U
hu4	HI×AŠ2
hu5	LUM
hub	HUB2×UD
hub2	HUB2
hubhub	ŠID×A
hubhub2	ŠID×IM
hubud	GIR3.ŠU.IG
hubur	NUNUZ.AB2×BI
huburx(BI)	BI
huburx(|NUNUZ.AB2×X|)	NUNUZ.AB2×X
hud	PA
hud2	UD
hud3	HI×BAD
hud4	ŠA6
hudbu	PA.KAK
huduš	TU
hug	EŠ2
huhud	UD.UD
hul	IGI.UR
hul2	HUL2
hul3	GIŠ%GIŠ
hul4	IGI.UR@s
hula	IGI.UR
hula2	HUL2
hulpad?	IGI.UR.RU.GAR
hulu	IGI.UR
huluh	LUH
hulum	DAG.KISIM5×LUM
hulum2	SAG×LUM
hulum3	DAG.KISIM5×HA
hulumx?(|SAG×HA|)	SAG×HA
hum	LUM
humu	LUM
humuh	LAGAB×U+A
hun	EŠ2
hunin	DAG.KISIM5×HA
hup	HUB2×UD
hup2	HUB2
hur	HI×AŠ2
hurim	NA.RU
hurin	NA.RU
hursag	PA.DUN3
hursaĝ	PA.DUN3
huru	HI×AŠ2
hurx(|KA×X|)	KA×X
hus	LUM
hus2	TAR
hutpu	PA.KAK
hux(KU)	KU
hux(MA2)	MA2
hux(RI)	RI
hux(SI)	SI
huya	UD.KUŠU2
huz?	LUM
huĝ	EŠ2
huš	HI.GIR3
huš2	GIR3
huša	HI.GIR3
hušux(|HI.GIR3|)	HI.GIR3
i	I
i'	ALEPH
i'2?	HI×NUN
i10	UD.DU
i11	HI
i14	MU
i15	E
i16	PI
i3	NI
i4	NI.UD
i5	KA
i6	TUG2
i7	A.LAGAB×HAL
i8	LAGAB×HAL
i9	ŠITA.GIŠ.TUG2
ia	I.A
ia10	A
ia3	NI
ia4	NI.UD
ia5	MU
ia7	TAB.TAB.AŠ
ia9	AŠ&AŠ&AŠ.TAB
ib	IB
ib2	TUM
ibbanunna	UD.HU.HI.NUN
ibbanunnax(|UD.HU.HI.NUN.NA|)	UD.HU.HI.NUN.NA
ibbi	IB
ibbix(NE)	NE
ibila	TUR.UŠ
ibila2	TUR.ARAD
ibila3	TUR.SAG
ibila4	TUR
ibira	KA×GIŠ%GIŠ
ibira2	KA×AŠ2
id	A2
id2	A.LAGAB×HAL
id3	LAGAB×HAL
id5?	A
id6	A.LAGAB×HAL.GAL
id7	A.LAGAB×HAL.DI
id8	UD×U+U+U
ida2	A.LAGAB×HAL
iddir?	A.PA.GISAL.PAD.SI.A
idenx(EDIN)	EDIN
idi	GA2×MI
idi2	A2
idi3	DA
idigna	MAŠ.GU2.GAR3
idignax(|GU2.GAR3|)	GU2.GAR3
idignu	MAŠ.GU2.GAR3
idim	IDIM
idin	BAD
idinx(DIN)	DIN
idx(|LAGAB×A|)	LAGAB×A
idx(|UD.ŠEŠ.KI|)	UD.ŠEŠ.KI
ie	I.A
ig	IG
ig2	E
ig3	NINDA2×NE
iga	IG
igar	E2.SIG4
igax(IGI)	IGI
igeštu	IGI.DU
igi	IGI
igi2	IGI@g
igi3?	KI.SAG
igigunux(IGI@g)	IGI@g
igira2	KI.SAG.SAL
igira?	IGI.BU
igirax(|KI.KA.SAL|)	KI.KA.SAL
igiru	KI.SAG.SAL
igištu	IGI.DU
igu	IGI
ih	HI×NUN
ih2	ALEPH
ii	I.A
ik	IG
iku	GAN2
iku2	GA2×AŠ
il	IL
il10	AL
il2	IL2
il3	AN
il4	DIŠ
il5	EL
il6	AL×ŠE
il8	IL×GAN2@t
il9?	LIL
ila	AN
ila2	IL2
ilamma?	LAGAB×IM
ilar	RU
ilba	GA2
ilba2	KASKAL.KUR
ildag	SUD2
ildag2	GUD×A+KUR
ildag3	GUD×KUR
ildag4	GEŠTIN×KUR
ildagx(|A.GUD×KUR|)	A.GUD×KUR
ildu	IGI.EŠ2.DU.ERIN2
ildu2	IGI.NAGAR.BU
ildu3	NAGAR.BU
ildum	IGI.EŠ2.DU.ERIN2
ildum2	IGI.NAGAR.BU
ildum3	NAGAR.BU
ilduma	IGI.EŠ2.DU.ERIN2
ilduma2	IGI.NAGAR.BU
ilduma3	NAGAR.BU
ildumma	IGI.EŠ2.DU.ERIN2
ildumma2	IGI.NAGAR.BU
ildumma3	NAGAR.BU
ildumx(BU)	BU
ildumx(NAGAR)	NAGAR
ildux(|IGI.NAGAR|)	IGI.NAGAR
ili	AN
ili2	IL2
ili5	EL
ili6	DIŠ
ili7	AN.ME.U.U.U
ilimmu2	TAB.TAB.TAB.TAB.AŠ
ilimmu3	ILIMMU3
ilimmu4	ILIMMU4
ilix(NI)	NI
illa	NAGAR
illag	LAGAB
illamma	LAGAB×IM
illar	RU
illat	KASKAL.KUR
illatu	KASKAL.KUR
illil	EN.KID
illil2	U&U.U&U.U
illu	A.KAL
illulu	RU
illur	RU
illuru	RU
ilu	AN
ilumer	IM
ilumer2	URU×IGI
ilumer3	LUL
ilx(GAN2@t)	GAN2@t
ilx(|AL.ŠE|)	AL.ŠE
im	IM
im2	DU@s
im3	NINDA2×NE
im5?	DU@g
im6	DU
imdudu	MUŠ
imerix(GIR3)	GIR3
imex(IM)	IM
imgaga	AŠ2.A.AN
imgaga2	AŠ2.AN.NA
imgaga3	AŠ2.AN
imgagax(|AŠ2.A|)	AŠ2.A
imhur2	IGI.BI
imhur3	IGI.GA
imhur4	IGI.A
imi	IM
imi2	GA2×AN
imin	IMIN
imin2	TAB.TAB.TAB.AŠ
imin3	AŠ&AŠ&AŠ.AŠ&AŠ&AŠ.AŠ
imina	IMIN
imina2	TAB.TAB.TAB.AŠ
imina3	AŠ&AŠ&AŠ.AŠ&AŠ&AŠ.AŠ
imma	KA×UD
imma2	KA×A
imma3	IGI@g
immal	NUN.LAGAR×MAŠ
immal2	NUN.LAGAR×SAL
immal3	GAR.ŠU.DUGUD
immalx(|NUN.LAGAR|)	NUN.LAGAR
immax?(|LAGAB×IGI@g|)	LAGAB×IGI@g
immeli?	KA×A
immen	KA×UD
immen2	KA×A
immin	KA×UD
immin2	KA×A
immindu	LAGAB×IM
immindu2	LAGAB×GAR
imminte	KA×ME+TE
imĝaĝa	AŠ2.A.AN
imĝaĝa2	AŠ2.AN.NA
imĝaĝa3	AŠ2.AN
imĝaĝax(|AŠ2.A|)	AŠ2.A
in	IN
in4	EN
in5	SAL.TUG2
in6	AŠ
ina	AŠ
ina2	IGI
inana	MUŠ3
inanna	MUŠ3
inbir	LU2@LU2
inbirx(|LU2.LU2|)	LU2.LU2
inda	NINDA2
inda2?	LAGAB×A.TAR
inda3	GAR
inda4	LAGAB×GAR
inda5	LAGAB×IM
indagarax?(|NINDA2×AŠ|)	NINDA2×AŠ
indagra	NINDA2×GUD
ingar	E2.SIG4
ini	IN
ini2	IGI
ini4	IGI.MIN
inim	KA
inini	MUŠ3
inna	DARA4
innana	MUŠ3
innin	MUŠ3
inta3?	GAR
inu2	IGI
inšušinak	MUŠ3.EREN
ip	IB
ip2	TUM
ipig	SIG
iq	IG
ir	IR
ir11	ARAD×KUR
ir13	LU2×EŠ2@t
ir17	DUN3@g@g
ir2	A.IGI
ir3	ARAD
ir4	URU
ir5	HI×AŠ2
ir6	A×IGI
ir7?	KASKAL
ir9	GIR3
ira2	A.IGI
irbura	TAK4
irda	ARAD
ire14	IR
irgi	GIR3.ZA@t
irhan	MUŠ
irhandix(|KA×GIŠ%GIŠ|)	KA×GIŠ%GIŠ
iri	URU
iri11	AB@g
iri12	AB
iri14	IR
iri8	IDIM
irib	AŠGAB
irib2	LAGAB×LUL
iribura	NUN%NUN
irigal	AB×GAL
irimmax(|URU×GAR|)	URU×GAR
irina	MUŠ%MUŠ.A.NA
irišeb	URU×HA
irkab	GAR.IB
irtu	GABA
irx(GIR2)	GIR2
irx(|GIR3×GAN2@t|)	GIR3×GAN2@t
irx?(|LU2×EŠ2.LAL|)	LU2×EŠ2.LAL
is	GIŠ
is2	IŠ
is3	AB
is5	U.U.U
isi	IŠ
isi2	GUL
isi3	U.AD
isib	ME
isim2	GUL
isim3	U.AD
isimu2	GUL
isimu3	U.AD
isimu4	PAP.IGI@g.NUN.ME
isimud	PAP.IGI@g
isin	PA.ŠE
isin2	IN
isinx(|ŠE.IGI.TUR|)	ŠE.IGI.TUR
isiš	IŠ
isiš2	A.IGI
isiš3	A×IGI
iski	E2
iskim	IGI.DUB
isurungal	UD.NUN
it	A2
it2	A.LAGAB×HAL
ita4	AN.A.LAGAB×HAL
ita5	A.LAGAB×HAL
itax(|UD.AN.ŠEŠ.KI|)	UD.AN.ŠEŠ.KI
iti	UD×U+U+U
iti2	UD@s×BAD
iti3	KASKAL.UD@s
iti4	AN.A.LAGAB×HAL
iti5	A.LAGAB×HAL
iti7?	UD×U+U+U.AN.ŠEŠ.KI
itid	UD×U+U+U
itid2	UD@s×BAD
itim	GA2×MI
itima	GA2×MI
itima2	UD×MI
itimax(|E2.MI|)	E2.MI
itimax(|E2×MI|)	E2×MI
itix(|UD.ŠEŠ.KI|)	UD.ŠEŠ.KI
itu	UD×U+U+U
itu2	UD@s×BAD
itu4	AN.A.LAGAB×HAL
itu5	A.LAGAB×HAL
itud	UD×U+U+U
itud2	UD@s×BAD
itudx(UD@s)	UD@s
itudx(|UD.AN.ŠEŠ.KI|)	UD.AN.ŠEŠ.KI
itudx(|UD×BAD|)	UD×BAD
iu	I.A
iu2	PI
iw	PI
ix(|A.LAGAB×A|)	A.LAGAB×A
ix(|LAGAB×A|)	LAGAB×A
ix(|LAGAB×HAL.A|)	LAGAB×HAL.A
iya	A.A
iyi	A.A
iyu	A.A
iyya	A.A
iyyi	A.A
iyyu	A.A
iz	GIŠ
iz2	IŠ
iz3	AB
izen	EZEN
izi	NE
izi2	KI.NE
izid	EŠ2
izim	EZEN
izin	EZEN
izkim	IGI.DUB
izu	NE
izun	EZEN
iĝ3	NINDA2×NE
iś	IŠ
iş	GIŠ
iş2	IŠ
iş3	AB
işu	GIŠ
iš	IŠ
iš10	UŠ
iš11	LAM×KUR
iš2	KASKAL
iš3	U.U.U
iš4	DIŠ
iš5	KA
iš6	GIŠ
iš7	AB
iš8	AŠ@z
iš9	EŠ2
išdu	DU@g
išdumx(DU@g)	DU@g
išgurx(IM)	IM
išhara	GA2×GAR
išhara2	ŠA3.LAGAB
išhara3	LAGAB.LAGAB
išhara4	GA2×PA
išhur4	GA2×PA
išhuru	GA2×GAR
išhuru2	URU×IGI
išhuru3	GAN2
išhuru4	GA2×PA
išhuru5	GA2×IŠ+HU+AŠ
išhurum3	GAN2
iši	IŠ
iši2	ŠU2.ANx3
išib	ME
išin	PA.ŠE
iškila?	ŠA3×A
iškili?	ŠA3×A
iškur	IM
išla	ŠA3×A
išli	ŠA3×A
ištar	MUŠ3
ištaran	KA.DI
išuruengal	A.LAGAB×HAL.UD.NUN.KI
iššebu	DIC.DIC.DIC.U.U
iššebux(|DIŠ.DIŠ.DIŠ.U.U.U|)	DIŠ.DIŠ.DIŠ.U.U.U
iţ	A2
ka	KA
ka...	GA2×AN.X
ka10	LUL.A
ka11	TE.A
ka13	HI×BAD
ka14	ZU
ka15	KAK
ka2	KA2
ka3	GA
ka4	SILA3
ka5	LUL
ka6	PEŠ2
ka7	DU@s
ka8?	BI
ka9	ŠID
kab	KAB
kab2	KA×A
kabar	PA.DAG.KISIM5×KAK
kabar2	DAG.KISIM5×KAK
kabta	TA@g
kabx(|SAG×A|)	SAG×A
kad	GAD
kad2	KAD2
kad3	KAD3
kad4	KAD4
kad5	KAD5
kad6	AŠ@z&AŠ@z&AŠ@z&AŠ@z
kad8	AŠ&AŠ&AŠ%AŠ&AŠ&AŠ
kadra	GAR.ŠA3.A
kadra2?	GAR.ŠA3
kadra3	GAR.ŠA3×A
kadrax(|ŠA3.A|)	ŠA3.A
kadri	GAR.ŠA3.A
kadri3	GAR.ŠA3×A
kadru	GAR.ŠA3.A
kadru3	GAR.ŠA3×A
kadx(LAK171@s)	LAK171@s
kag2	KA
kagar	IG
kak	KAK
kak2	KA
kakkala	KU7
kakkuda	KU7
kakkul	U.DIM×ŠE
kakkul2	DIM×ŠE
kakkul3	U.DIM
kakkula	KU7
kakkuša	KU7
kakra	IM
kakru	IM
kaku	DU@s
kal	KAL
kal2	GAL
kal3	KAK
kal4	SAL
kala	KAL
kala10	LAGAB×DAR
kala2	SAL.LA
kala3	LAGAB×U
kala4	LAGAB×AL
kala5	LAGAB×KI
kalag	KAL
kalaga	KAL
kalam	UN
kalam2?	HI×ŠE
kalama	UN
kalamx(UN@g)	UN@g
kalax(GAN2)	GAN2
kalbu	UR
kalga	KAL
kam	HI×BAD
kam2	KAM2
kam3	KAD4
kam4	KAM4
kama	HI×BAD
kama5	LU2×HI×BAD
kamaš	DU@s
kamuš	GUD
kamx(LAK171@s)	LAK171@s
kamx(TAK4)	TAK4
kan	GAN
kan2	GAN2
kan3	SAG×MI
kan4	KA2
kan5	KA×MI
kan6	KA×GAN2@t
kana	GAN
kana2	GAN2
kana3	SAG×MI
kana5	KA×MI
kana6	KA×GAN2@t
kana7	GIŠ@t
kanam	UN
kanaĝ	UN
kankal	KI.KAL
kankan	KA2
kap	KAB
kapa	KAB
kapar	PA.DAG.KISIM5×KAK
kapara3?	LU2.LU2.LU2.LU2
kaptu	DUGUD
kaq	KAK
kar	TE.A
kar2	GAN2@t
kar3	GAR3
kar4	HA@g
kar5	GAR
kara	TE.A
kara2	GAN2@t
kara4	KAD4
kara6	GUR7
karadin	(ŠE.NUN&NUN)&(ŠE.NUN&NUN).GAD&GAD.GAR&GAR
karadin10	U&U.PA&PA.GAR&GAR
karadin2	ŠE&ŠE.GAD&GAD.GAR&GAR
karadin3	ŠE&ŠE.TAB&TAB.GAR&GAR
karadin4	(ŠE.NUN&NUN)&(ŠE.NUN&NUN).LAGAB.LAGAB
karadin5?	LAGAB.LAGAB
karadin6?	(ŠE.NUN&NUN)&(ŠE.NUN&NUN)
karadin7	ŠE&ŠE.PA&PA.GAR&GAR
karadin8	ŠE&ŠE.GAR&GAR
karadin9	U&U.SUR&SUR
karam	GA2×UD
karax(LAK171@s)	LAK171@s
karax(ZI3)	ZI3
karaš	KI.KAL×BAD
karaš2	KI.KAL
karašx(|KI.KAL.BAD.IDIM|)	KI.KAL.BAD.IDIM
karašx(|KI.KAL.BAD|)	KI.KAL.BAD
karašx(|LU2.LU2.LU2.LU2|)	LU2.LU2.LU2.LU2
karkar	IM
karkara	IM
karx(GAN2)	GAN2
karx(LAK171@s)	LAK171@s
karx(ZI3)	ZI3
karx?(KAD4)	KAD4
kas	KASKAL
kas2	BI
kas3	GUM×ŠE
kas4	DU@s
kas5	DU@g
kas6	GUM
kas7	ŠID
kasa	KASKAL
kaskal	KASKAL
kat	GAD
kat2	KAD2
kat3	KAD3
kat4	KAD4
kat5	KAD5
kat7	ŠU
kata3	KAD3
kaz	GUM×ŠE
kaz8	HI×AŠ
kaz9?	UD.HI×AŠ2
kazab	U2
kazabu	U2
kazabur	U2
kazaza	HI×AŠ
kazbi	U2
kazbu	U2
kaĝeškarax(|GIŠ.KA.KAD4|)	GIŠ.KA.KAD4
kaş	BI
kaş3	GUM×ŠE
kaš	BI
kaš-bir8	BI.A.SUD
kaš2	KASKAL
kaš3	UŠ×A
kaš4	DU@s
kaš5	DU
kaš6	GUM×ŠE
kašbir	BI.A.SUD
kašbirx(|A.SUD|)	A.SUD
kaššeba2	ALAN
kaššeba3?	GUD&GUD.LUGAL
kaššebi2	ALAN
kaššebi3?	GUD&GUD.LUGAL
ke	KI
ke2	GI
ke3	AK
ke4	KID
ke5	DIM2
kel	LAGAB
kel3	LAGAB.LAGAB
kele	LAGAB
kenke	KIN.KIN
keš18	UD.KUŠU2
keš2	KEŠ2
keš3	ŠU2.AN.HI×GAD
keš4	SAG@n
keš7?	DAG.KISIM5×GI
keš8	DAG.KISIM5×GIR2
keš9	DAG.KISIM5×U2+GIR2
kešda	KEŠ2
keše2	KEŠ2
keše4	SAG@n
keši18	UD.KUŠU2
keši2	KEŠ2
keši3	ŠU2.AN.HI×GAD
kešx(KIŠ)	KIŠ
kešx(U2)	U2
ki	KI
ki2	GI
ki3	AK
ki4	KID
ki5	DIM2
ki6	ZU
ki7	KAK
ki8	GI4
kib	GIŠ%GIŠ
kibini	KI.BI.NI
kibir2	ŠU2.AŠ2
kibir3	ŠU2.AN
kibsur	GAR.LAGAB
kibšur	GAR.LAGAB
kid	KID
kid10	BU
kid2	TAK4
kid3	AK
kid4	ŠID
kid5	KAD4
kid6	KAD5
kid7	IM×TAK4
kid8	SAL.TAK4
kid9	GAD
kidx(LAK171@s)	LAK171@s
kig2	KIN
kik	GIG
kikken	HI×AŠ2
kikken2	HI×AŠ2.HI×AŠ2
kikkin	HI×AŠ2
kikkin2	HI×AŠ2.HI×AŠ2
kikla	KI.KAL
kil	LAGAB
kil2	GI%GI
kil3	LAGAB.LAGAB
kil4	GAD.TAK4
kilahha	KI.UD.A
kilax(|LAGAB.LAGAB|)	LAGAB.LAGAB
kili	LAGAB
kili3	LAGAB.LAGAB
kilib	LAGAB
kilib3	LAGAB.LAGAB
kilibu	U2
kilim	PEŠ2
kilim2	GI%GI
kilim3	GI.KAK
kilin	PEŠ2
kilux(|LAGAB.LAGAB|)	LAGAB.LAGAB
kilx(|GI4&GI4|)	GI4&GI4
kim	DIM2
kim2	KAD4
kim3	BU
kim4	DU@s
kim5	DU@g
kim6	DU
kimin	KI.MIN
kimx(KAD5)	KAD5
kimx(KIN)	KIN
kimx(LAK171@s)	LAK171@s
kin	KIN
kin2	HI×AŠ2
kin3	KUR
kin4	LAGAB.LAGAB
kin5?	URU×BAR
kin7	DU
kin8	DIM2
kinbur	LAGAB×A+LAL
kinda	GAD&GAD.GAR&GAR
kinda2	URI
kindagal	GAL.GAD&GAD.GAR&GAR
kindagal2	GAL.URI
kindaĝal	GAL.GAD&GAD.GAR&GAR
kinga?	KIN
kingal	GAL.URU×BAR
kingusila	KINGUSILI
kingusili	KINGUSILI
kingusili2	U&U.U&U.U
kinkin	HI×AŠ2
kinkin2	HI×AŠ2.HI×AŠ2
kinx(|ŠE.KIN|)	ŠE.KIN
kip	GIŠ%GIŠ
kir	HA@g
kir10	GIR3
kir11	SAL.GA2×PA
kir12?	U.EN×GAN2@t
kir13	U.AD
kir14	KA×KAK
kir2	AB2×ŠA3
kir3	LAGAB
kir4	KA
kir5	IDIM
kir6	AB2×GAN2@t
kir7	NIM×GAR+GAN2@t
kir8	TE.A
kir9	HA
kiraš	ARAD×KUR
kiraši	AŠ2.A.AN
kirašix(|AŠ2.AN.NA|)	AŠ2.AN.NA
kirašix(|AŠ2.AN|)	AŠ2.AN
kirbanu?	ŠID×A
kiri	HA@g
kiri2	GAN2@t
kiri3	KA
kiri4	ŠA3×A
kiri5	GIR3
kiri6	SAR
kiri7	KEŠ2
kiri8	ŠID
kiri9	AB2×ŠA3
kirid	KEŠ2
kirim?	DAG.KISIM5×GIR2
kiris	KEŠ2
kirit	KEŠ2
kirix(ZI3)	ZI3
kirix(|KA×IM|)	KA×IM
kirix(|U.AD|)	U.AD
kirrux(|U.EN×GAN2@t|)	U.EN×GAN2@t
kirx(|AB2.ŠA3|)	AB2.ŠA3
kirx(|AB2×TAK4|)	AB2×TAK4
kis	KIŠ
kis2	GIŠ
kisal	KISAL
kisi	UŠ×A
kisig	EZEN×KU3
kisig2	EZEN×IGI@g
kisiga	EZEN×KU3
kisim	DAG.KISIM5×U2+GIR2
kisim2	DAG.KISIM5×SI
kisim3	DAG.KISIM5×LU+MAŠ2
kisim4	DAG.KISIM5×GIR2
kisim5	KISIM5
kisim6	GA.LAGAB
kisim7	DAG.KISIM5×GA
kisix(|DAG.KISIM5×GIR2|)	DAG.KISIM5×GIR2
kislah	KI.UD
kislah2	KI×UD
kislah3	KI.KAL
kissa	KI.ŠEŠ.KAK
kit	KID
kit10	BU
kit2	TAK4
kit9	GAD
kitim	GIDIM
kizlah	KI.UD
kiĝ	GIG
kiĝ2	KIN
kiş	KIŠ
kiš	KIŠ
kiš16	U2.GIR2@g
kiš2	KEŠ2
kiš5	PEŠ2
kiša	U2.GIR2@g
kiša2	GIR2@g
kišag	EZEN×KU3
kišeg	U2.GIR2@g
kišeg2	GIR2@g
kišek	U2.GIR2@g
kišer	GIR3.BAR
kišex(KIŠ)	KIŠ
kiši	KIŠ
kiši10	U.PIRIG
kiši11	IDIM&IDIM.BUR
kiši12	NUN.ŠE
kiši13	HI×NUN.KASKAL
kiši14	ŠU2.NAGA
kiši15	KASKAL.HI×NUN
kiši16	U2.GIR2@g
kiši17	GIR2@g
kiši2	KEŠ2
kiši3	ŠU2.AN.HI×GAD
kiši4	SAG@n
kiši5	PEŠ2
kiši6	ŠEG9
kiši7	DAG.KISIM5×GI
kiši8	DAG.KISIM5×GIR2
kiši9	DAG.KISIM5×U2+GIR2
kišib	MES
kišib2	PEŠ2
kišib3	DUB
kišig	U2.GIR2@g
kišig2	GIR2@g
kišik	U2.GIR2@g
kišik2	GIR2@g
kišim5	KISIM5
kišix(|KI.SAG@n|)	KI.SAG@n
kišādu	GU2
kiţ	KID
ku	KU
ku10	MI
ku10-ku10	MI
ku11	KI
ku12	DAG.KISIM5×X
ku13	GUM
ku14	KUN
ku15	GUD
ku16	NE
ku2	KA×GAR
ku3	KU3
ku3-babbar	KU3.UD
ku3-sig17	KU3.GI
ku4	KU4
ku5	TAR
ku6	HA
ku7	KU7
ku7-ku7	KU7.KU7
ku8	GU
ku9	KUL
kua	HA
kua2	UD.KUŠU2
kuar	HA.A
kuar2	A.HA
kuara	HA.A
kuara2	A.HA
kub	DU
kub4?	KID
kud	TAR
kud3	KU
kud5	KU7
kud6	KAD3
kudma	TAR
kug	KU3
kugre	KA×GUR7
kugu	HI
kugur	KA×GUR7
kuia	UD.KUŠU2
kuk	KU3
kuk2	LU3
kukku	KU7.KU7
kukku2	MI.MI
kukku3	KI.KI
kukku4	KI.MUŠ3@g
kukku5	MI
kukkuda	KU7
kukkuda2	IŠ
kukkug2	MI.MI
kukkuš	IŠ
kukkuša	KU7
kuksu	TAR
kuksu2	KAK.TAR
kuku5	MI
kukuda2	IŠ
kukula	KU7
kukux(|LUGAL&LUGAL|)	LUGAL&LUGAL
kul	KUL
kul2	GUL
kula	KUL
kulkul	KA×GA.SAG
kulla	SIG4
kullux(SIG4)	SIG4
kulu	KUL
kulx(BAL)	BAL
kulx(|GIŠ.KUL|)	GIŠ.KUL
kum	GUM
kum2	NE
kum3	EZEN×KASKAL
kum4	UD
kumx(PA)	PA
kumx(|GUM×ŠE|)	GUM×ŠE
kun	KUN
kun10	KIN
kun2	PA
kun3	GUM
kun4	I.LU
kun5	TUR.EŠ2
kun8	MAŠ2
kun9	NE
kunga	ŠU2.ANx3
kunga2	ŠU2.AN
kunga3	ANx3
kungal	HUL2
kungax(|BAR.AN&AN.AN|)	BAR.AN&AN.AN
kungi	ŠU2.ANx3
kungi2	ŠU2.AN
kungi3	ANx3
kunigara	AN.BARA2
kunigara2	AN.MUŠ
kunigara3	AN.TU
kunigara4	MUŠ%MUŠ
kunigara5	A.LU3
kunin	LAGAB×KUL
kunin2	LAGAB×A
kunin3?	LAGAB×BI
kuninx(|A.LAGAB×KUL|)	A.LAGAB×KUL
kuninx(|LAGAB×GAR|)	LAGAB×GAR
kunu	KUN
kunx?(LUM)	LUM
kup	DU
kup3	HUB2
kup4?	KID
kur	KUR
kur11	NUN@t.KI
kur12	URU×GU
kur14	E.TUM
kur15	GA
kur2	PAP
kur3	GUR
kur4	LAGAB
kur5	TAR
kur6	PAD
kur7	IGI.ERIN2
kur8?	KA×GAR
kur9	KU4
kurinx(DUG)	DUG
kurku	ME.AN.ŠE.NAGA
kurku2	KA.AN.NI.SI
kurnun?	LAL2
kurrunx(GURUN)	GURUN
kuru	E.SUD.HUB2×UD
kuru11	NUN@t.KI
kuru13	GUR7
kuru14	E.TUM
kuru2	PAP
kuru4	LAGAB
kuru5	TAR
kuru7	IGI.ERIN2
kurud	NUN@t.KI
kuruda	NUN@t.KI
kurul14	E.TUM
kurulx(|E.TUM.GA2×NUN&NUN|)	E.TUM.GA2×NUN&NUN
kurum10	DUG
kurum5	TAR
kurum6	PAD
kurum7	IGI.ERIN2
kurummax(PAD)	PAD
kurun	BI.DIN
kurun2	DIN
kurun3	DUG
kurun5	BI.MI
kurun6	GURUN
kurunx(|BAD.IGI.BAD|)	BAD.IGI.BAD
kurunx(|IDIM&IDIM.BUR|)	IDIM&IDIM.BUR
kurunx(|IDIM&IDIM×4|)	IDIM&IDIM×4
kurunx(|IDIM×4|)	IDIM×4
kurunx(|TAB×4|)	TAB×4
kuruš	KU7
kurušda	KU7
kurušdax(KWU822)	KWU822
kurx(DU)	DU
kurx(KU4~a)	KU4~a
kurx(LIL)	LIL
kus	SU
kus2	LUM
kut	TAR
kut2	GAD
kutu	TAR
kutu2?	RA.RA
kuwa2	UD.KUŠU2
kux(DU)	DU
kux(GAR)	GAR
kux(KU4~a)	KU4~a
kux(LAGAB)	LAGAB
kux(|NIM×GAN2@t|)	NIM×GAN2@t
kuya2	UD.KUŠU2
kuyax(|SAL.KUŠU2|)	SAL.KUŠU2
kuz	SU
kuz3	KU
kuzbi	U2
kuzbu	U2
kuĝ4	I.LU
kuĝ5	TUR.EŠ2
kuĝx?(LUM)	LUM
kuş2	LUM
kuš	SU
kuš10	PEŠ2
kuš2	SAG@g
kuš3	U2
kuš4	PA.AN
kuš5	U.PIRIG
kuš6	KU7
kuš7	IŠ
kuš8	HUL2
kuš9	KUŠU2
kušax(|UD.KUŠU2|)	UD.KUŠU2
kušdim	GUD
kušgim	GUD
kušlug	KI.NE
kušu	U.PIRIG
kušu2	KUŠU2
kušu3	UD.KUŠU2
kušu4	SAG@g
kušum	BI.LUL
kušum2	LUL
kušum3	GUD
kušum4	U.PIRIG
kušumx(U2)	U2
kušux(|SAL.KUŠU2|)	SAL.KUŠU2
kušx(|SAL.KUŠU2|)	SAL.KUŠU2
la	LA
la'u	LAL2
la'u3	LAL2.NI
la'u4	LAL2.KAK
la'u5	LAL2.A
la'u6	LAL.NI
la'u7	LAL.KAK
la'ux(|LAL2.U|)	LAL2.U
la10	ŠID
la12	LAM
la2	LAL
la3	NU
la4?	DU&DU
la5	LAL2
la6	KAL
la7	UD
la8	EDIN
lab	KAL
lab2?	LUL
laban	EZEN×LA
lag	ŠID
lagab	LAGAB
lagabx(GUD)	GUD
lagal	LAGAR
lagar	LAGAR
lagar2	SAL.ME
lagar3	SAL.HUB2
lagarx(SAL)	SAL
lagas	NU11.BUR.LA
lagasa	NU11.BUR.LA
lagaš	NU11.BUR.LA
lagaša	NU11.BUR.LA
lah	UD
lah2	ERIN2
lah3	LUH
lah4	DU&DU
lah5	DU.DU
lah6	DU
lah7	DU@s.DU@s
laha3?	LUH
laha4	DU&DU
laha5	DU.DU
lahar	LAGAB×GUD+GUD
lahar2	DARA4
laharx(|SIK2.AŠ|)	SIK2.AŠ
lahhušu	SIG4&SIG4.ŠU2
lahhušux(|SIG4.SIG4.ŠU2|)	SIG4.SIG4.ŠU2
lahra?	AŠ2.A.AN
lahrax(|LAGAB×GUD+GUD|)	LAGAB×GUD+GUD
lahru	LAGAB×GUD+GUD
lahrum	LAGAB×GUD+GUD
lahrum2	DARA4
lahrux(|SIK2.AŠ|)	SIK2.AŠ
lahta6	DAG.KISIM5×LA
lahtan	NUNUZ.AB2×LA
lahtan2	NUNUZ.AB2×SILA3
lahtan3	NUNUZ.KISIM5×BI.U
lahtan4	NUNUZ.AB2×NE
lahtan5	NUNUZ.AB2×DUG
lahtan6	DAG.KISIM5×LA
lahtax(|NUNUZ.AB2×LA|)	NUNUZ.AB2×LA
lahx(|DU&DU.DU&DU|)	DU&DU.DU&DU
lahx(|DU.DU.DU.DU|)	DU.DU.DU.DU
lahšu	LAHŠU
lak	ŠID
laka	ŠID
lal	LAL
lal'u	LAL2
lal'u3	LAL2.NI
lal'u4	LAL2.KAK
lal'u5	LAL2.A
lal'u6	LAL.NI
lal'u7	LAL.KAK
lal-lal	LAL2
lal2	LAL2
lal3	TA×HI
lal5?	ŠU2.U.U.U
lal6?	ŠU2.NE
lala2	KAL
lalah	DU&DU
lalah2	DU.DU
lalahx(|DU.DU.DU.DU|)	DU.DU.DU.DU
lalla	LAL2
lalla2	IGI.IGI
lallal	LAL2
lam	LAM
lam2	NE
lam3	DAM
lam4	LIMMU2
lam5	IGI
lam7?	LAM×KUR
lama	LAM
lama2	NE
lama3	KAL
lamahuš	ZI&ZI.LAGAB
lamahušx(|A.ZI&ZI|)	A.ZI&ZI
lamahušx(|ZI&ZI.A|)	ZI&ZI.A
lamahušx(|ZI&ZI.EŠ2|)	ZI&ZI.EŠ2
lamassu	KAL
lambi	ŠA3.SAR
lamga?	NAGAR
lamhu	KUR@KUR
lamma	KAL
lammar	KAL
lammax(LAM)	LAM
lammu	LIMMU
lammu2	LIMMU2
lammu6?	LAGAB×HAL
lamx(LUM)	LUM
lap	KAL
laq	ŠID
lar	PA
larag	UD.UD.AK
larag2	UD.UD
larax(|NUN&NUN|)	NUN&NUN
larsa	UD.AB@g
larsa2	UD.AB
larsam	UD.AB@g
larsam2	UD.AB
lat	KUR
laţ	KUR
le	LI
le'um	DUB
le10	DA
le2	NI
le3	IGI
le4	AN
le8	AB2
le9	NE
lel2	KID
lel4?	KISAL
lelle	IGI.IGI
lelli	IGI.IGI
lem	IGI
lem4	NE
lep	LUL
li	LI
li10	DA
li11	NUN
li12	LIŠ
li2	NI
li3	IGI
li5	ŠA
li6	GAN
li7	UR
li8	AB2
li9	NE
lib	LUL
lib2	KAL
lib3	ŠA3
lib4	IGI
lib5?	SAG×UM
libi	LUL
libin	EZEN×LI
libir	IGI.EŠ2
libit	BA
libiš	AB2×ŠA3
libišx(|AB2.ŠA3|)	AB2.ŠA3
libišx(|AB2×TAK4|)	AB2×TAK4
libx(NI)	NI
libx(|NI.LU|)	NI.LU
lid	AB2
lid2	NI
lidda	ŠITA
lidda2	ŠA3.DIŠ
liddax(|ŠITA2|)	ŠITA2
lidim	AL×DIM2
lidx(|ŠA3.DIŠ|)	ŠA3.DIŠ
ligidba	ŠIM.AN.SAL.TUG2.IB
ligidba2	ŠIM.AN.MAŠ
ligim	IGI.TUR.TUR
ligima	IGI.TUR.TUR
ligin	IGI.TUR.TUR
lih	UD
lih2	ERIN2
lih3	LUH
lih4?	LIŠ
lik	UR
lik2	ŠID
lil	LIL
lil2	KID
lil3	ŠU2.U.U.U
lil5	ŠU2.NE
lil6	GU2
lil7	BAHAR2
lil8	LU2@t
lila2	KID
lilib	IGI.IGI
lilis	AB2×BALAG
liliz	AB2×BALAG
lillan	LUGAL
lilli	IGI.IGI
lillu	BAHAR2
lilx(KU4)	KU4
lilx?(|ŠU&ŠU@180|)	ŠU&ŠU@180
lim	IGI
lim2	LIMMU2
lim3	LAM
lim4	NE
lima	IGI
limi	IGI
limmu	LIMMU
limmu2	LIMMU2
limmu4	AŠ&AŠ&AŠ.AŠ
limmux(LIMMU~a)	LIMMU~a
limmux(LIMMU~b)	LIMMU~b
limu	LIMMU
limu2	LIMMU2
limu4	AŠ&AŠ&AŠ.AŠ
limx(BUR)	BUR
lip	LUL
lip2	KAL
lipiš	AB2×ŠA3
lipišx(|AB2.ŠA3|)	AB2.ŠA3
liq	UR
liq2	ŠID
liq3	A.HU.SI
lir	NUN&NUN
liri	ŠU.KAL
liri2	AŠ
liri3	GIŠ%GIŠ
liri4	A2.KAL
liri5	A2.AŠ
liri6	NUN%NUN
liri7	KAL%KAL
liri8	UR%UR
liru	ŠU.KAL
liru2	AŠ
liru3	GIŠ%GIŠ
liru4	A2.KAL
liru5	A2.AŠ
liru6	NUN%NUN
liru7	KAL%KAL
liru8	UR%UR
lirum	ŠU.KAL
lirum2	AŠ
lirum3	GIŠ%GIŠ
lirum4	A2.KAL
lirum5	A2.AŠ
lirum6	NUN%NUN
lirum7	KAL%KAL
lirum8	UR%UR
lirumx(|GA2&GA2|)	GA2&GA2
lirumx(|GAN2&GAN2|)	GAN2&GAN2
lirumx(|GIŠ%GIŠ.ZA|)	GIŠ%GIŠ.ZA
lis	LIŠ
lisi	NE.SI@g
lisin	NE.SI@g
lit	AB2
liti	AB2
lium	GUD.AN.NA
liz	LIŠ
liš	LIŠ
liţ	AB2
liţ2	DUG
liţi	AB2
lu	LU
lu10	DAG.KISIM5×X
lu2	LU2
lu3	LU3
lu4	LUM
lu5	LUL
lu6	UR
lu7	URU×MIN
lu8	URU
lu9	PA
lub	LUL
lubun	EZEN×LU
lud	DUG
lug	LU
lug2	PA
luga	PA.GA2
lugal	LUGAL
lugala	LUGAL
lugud	BAD.UD
lugud2	LAGAB
lugud3	LUM&LUM.GAR&GAR
lugud4	LAGAR×ŠE+SUM
lugx(LAM)	LAM
lugx(LUL)	LUL
luh	LUH
luhu	LUH
luhum?	LUM.LUM
luhummu	GIŠ.MI
luhumx?(|GIŠ.MI|)	GIŠ.MI
luhx(UD)	UD
luhša	HI×NUN.ME.U
luhšax(|SUMAŠ.ME|)	SUMAŠ.ME
luhšu	HI×NUN.ME.U
lukur	SAL.ME
lul	LUL
lulim	GIR3×LU+IGI
lulima	GIR3×LU+IGI
lulu	LUL
lum	LUM
lum2	IGI
lum3	DUG
luma	LUM
lumgi	ŠIM
lumgi2	ŠIM×A
lumgi3	ŠIM×GAR
lumha	BALAG
lumhax(EGIR)	EGIR
lumu	LUM
lumu3	DUG
lumx(MURGU2)	MURGU2
lumx(|DUG.DUG|)	DUG.DUG
lumx?(|ZU&ZU.SAR|)	ZU&ZU.SAR
lun	PA
lunga	ŠIM
lunga2	ŠIM×A
lunga3	ŠIM×GAR
lungax(|BI.DAR|)	BI.DAR
lungax(|BI×GAR|)	BI×GAR
lup	LUL
lut	DUG
lutu	DUG
lux(LAL)	LAL
luĝ2	PA
luĝa	PA.GA2
luţ	DUG
luţu	DUG
lāsimu	DU@s
m/wāşit	UD
ma	MA
ma2	MA2
ma3	GA2
ma4	SAR
ma5	KA×EŠ2
ma6	ME
ma7	MAŠ
ma8	KA×SAR
ma9	PI
mabi	MUŠ3×A+DI
mabi2	A.MUŠ3.DI
mabi3	ZA.MUŠ3.DI
mabix(|A.MUŠ3×A.DI|)	A.MUŠ3×A.DI
mabix(|MUŠ3.DI|)	MUŠ3.DI
mad	KUR
mada	SAL.UŠ.DAM
madal	BU
madax(|UŠ.DAM|)	UŠ.DAM
madla	BU
madlu	BU
magar	BULUG
magara	BULUG
mah	MAH
mah2	AL
mah3	U.KA
maha	MAH
maha2	AL
mahar2?	U.SAR
mahru	IGI.DU
makaš	DIŠ
makaš2	AŠ
makkaš	DIŠ
makkaš2	AŠ
mal	GA2
mal2	SI.A
mal3	IG
mal4?	LIŠ
mala	GA2
malba	KI.LAM
malga?	GA2×GAR
malla	BU
malug?	GA2×AN.LUL
mam	U.U
mam2	SAL
mam3	SAL.MA
mammi	MUŠ3×A+DI
mammi2	A.MUŠ3.DI
mammi3	ZA.MUŠ3.DI
mammix(|A.MUŠ3×A.DI|)	A.MUŠ3×A.DI
mammix(|MUŠ3.DI|)	MUŠ3.DI
man	U.U
man2	SAL
man3	AŠ.AŠ
mana	U.U
mangaga?	KA×SA
mangara	BULUG
mar	MAR
mar2	AMAR
mar3	GAR
mar6	HI×AŠ2
mara	MAR
mara2	AMAR
marad	AMAR
marad2	AMAR.DA
marduk	AMAR.UD
maru	TUR
mas	MAŠ
massa	DAG.KISIM5×GA+MAŠ
massa2	DAG.KISIM5×A+MAŠ
mat	U2
mat2	BAD
mat3	HU.HI
max(|GA2×AN|)	GA2×AN
maz2	MAŠ2
maś?	MAŠ
maş?	MAŠ
maš	MAŠ
maš2	MAŠ2
maš3	MAŠ.PA
maš4	PA
maša	MAŠ
mašaku	MAŠ2
mašammi	U2
mašda	MAŠ.KAK
mašda2	MAŠ.EN.KAK
mašda3	MAŠ.KAK.EN
mašda4	EN.MAŠ.KAK
mašgi?	U&U.U@v&U@v
maškim	PA.DU@s
maškim2	PA.DU@g
maškim3	PA.DU
mašmin	MAŠ.MIN
maššam	U2
maţ	KUR
me	ME
me10	NI2
me11	AK×ŠITA+GIŠ
me2	MI
me3	AK×ERIN2
me4	BAD
me5	A
me6	AK
me7	GA2×KASKAL
me8	PI
me9	LAGAB×ŠITA@t+GIŠ
mebulug	URUDA
mebulug2	BULUG&BULUG
mebulug3	DUB
medda	KU.AN
medda2	KU.IDIM
meddu	KU.AN
meddu2	KU.IDIM
medu	KA×ME+DU
megida	TAB.TI
megida2	TAB.KUN
megidax(KUN)	KUN
megidax?(|SAL.TAB.KUN|)	SAL.TAB.KUN
megidda	TAB.TI
megidda2	TAB.KUN
mehida	MU
mehidi	MU
mehidu	MU
mel	IŠ
mel2	KA×LI
mel3	KI.NE
mele2	KA×LI
melex(|KA×GAR+ŠA3+A|)	KA×GAR+ŠA3+A
melex(|KA×U2|)	KA×U2
meli	KI.NE
meli2	KA×LI
melix(|KA×GAR+ŠA3+A|)	KA×GAR+ŠA3+A
melix(|KA×U2|)	KA×U2
mem	SAL
men	GA2×ME+EN
men2	ME
men3	DU
men4	LAGAB×ME+EN
men5	U.U
menari	GAR
menax(|GA2×ME+EN|)	GA2×ME+EN
menbulug	URUDA
menbulug2	BULUG&BULUG
menbulug3	DUB
menx(MIN)	MIN
menx(|GA2×EN|)	GA2×EN
mer	DUN3@g@g
mer2?	IM
mer3	GIR2
mer4	ŠID
mere	DUN3@g@g
meri3	GIR2
merimer	EN%EN
merimer2	EN×4
merimer3	IM%IM
merimer4	IM×4
merimer5	KU&HI×AŠ2.KU&HI×AŠ2
merimeri	EN%EN
merimeri2	EN×4
merimeri3	IM%IM
merimeri4	IM×4
merimeri5	KU&HI×AŠ2.KU&HI×AŠ2
mermer	EN%EN
mermer2	EN×4
mermer3	IM%IM
mermer4	IM×4
mermer5	KU&HI×AŠ2.KU&HI×AŠ2
mermeri	EN%EN
mermeri2	EN×4
mermeri3	IM%IM
mermeri4	IM×4
mermeri5	KU&HI×AŠ2.KU&HI×AŠ2
merx(GIR3)	GIR3
mes	MES
mes2?	DUB
mes3	ME.U.U.U
mesa	MES
mesi	MES
mete	TE.ME
mex(KA)	KA
mex(SAL)	SAL
mex(|KA×ERIN2|)	KA×ERIN2
mex(|LAGAB×ŠITA+GIŠ+ERIN2|)	LAGAB×ŠITA+GIŠ+ERIN2
mex(|UZ3×KASKAL|)	UZ3×KASKAL
mex(ŠITA)	ŠITA
mez	MES
meze	AB2×ME+EN
mezeg	ŠID×A
mezem	ŠID×A
mezeĝ	ŠID×A
meš	ME.U.U.U
meš2	ME
meš3	MES
meša	KA×ME+DU
meštunux(PI)	PI
mešx(UŠ)	UŠ
mešx(|U.U|)	U.U
meţa	KU.AN
meţa2	KU.IDIM
meţu	KU.AN
meţu2	KU.IDIM
mi	MI
mi2	SAL
mi3	ME
mi4	GA2×ME+EN
mi5	PI
mid	IDIM
midda	KU.AN
midda2	KU.IDIM
middu	KU.AN
middu2	KU.IDIM
midra	PA
migir	DUN3@g@g
migir2	DUN4
mih	MAH
mil	IŠ
mili	IŠ
mili2	KA×LI
milla	IŠ
mim	SAL
mim-ma	SAL.MA
mim2?	MUŠ3
mim3	U.U
mim4	SAL.MA
min	MIN
min2	SAL
min3	U.U
min4	SAL.TUG2
min5	AŠ.AŠ
min6	TAB
min7	GA2×ME+EN
mina	MIN
mina3	U.U
minbulug	URUDA
minbulug2	BULUG&BULUG
minbulugx(|BAL&BAL|)	BAL&BAL
minbulugx(|BULUG.NAGAR|)	BULUG.NAGAR
mir	DUN3@g@g
mir2?	IM
mir5	EZEN×DUN3@g@g
miri	DUN3@g@g
mirix(GIR2)	GIR2
mirix(GIR3)	GIR3
mirx(KAL)	KAL
mirx(|SAL.GA2×PA|)	SAL.GA2×PA
mis	MES
misal	GIŠ.TUG2.PI.ŠIR.SILA3
mit	BAD
mitta	KU.AN
mitta2	KU.IDIM
mittu	KU.AN
mittu2	KU.IDIM
mitu	BAD
mitum	KU.AN
mitum2	KU.IDIM
mix(DU)	DU
mizeg	ŠID×A
mizem	ŠID×A
miş	MES
miš	MES
miš2	ME.U.U.U
miš3	GIŠ
mišhaš	GIŠ.TAR
mišsun	GIŠ.BAD
mištunux(PI)	PI
mišx(UŠ)	UŠ
miţ	BAD
miţa	KU.AN
miţa2	KU.IDIM
miţu	KU.AN
miţu2	KU.IDIM
miţţu	KU.AN
mu	MU
mu10	SAL
mu11	KA×SAR
mu12	HU.HI
mu13	KA×ŠA
mu14	A
mu2	SAR
mu3	KA×EŠ2
mu4	TUG2
mu5	NI
mu6	PA
mu7	KA×LI
mu8	GAR
mu9	GIŠ
mua	PA
muati	PA
muatu	PA
mud	HU.HI
mud2	BAD
mud3	NUNUZ.AB2×BI
mud4	LAGAB.U.KAK
mud5	ŠIM
mud6	SAR
mud7	ZI&ZI.LAGAB
mud8	NUNUZ.AB2×KAD3
mudgi	BAD.MI
mudla	BU
mudlu	BU
mudnax(|SAL.UŠ.DAM|)	SAL.UŠ.DAM
mudra3	BU
mudra5	SIK2.BU
mudra6	MU.BU
mudrax(|SIG.MU.BU|)	SIG.MU.BU
mudru	PA
mudru2	EN.KU.A
mudru3	BU
mudru4	SIK2.AŠ
mudru5	SIK2.BU
mudru6	MU.BU
mudrum4	SIK2.AŠ
mudul	BU
mudx(GU2@g)	GU2@g
mudx(|A.ZI&ZI|)	A.ZI&ZI
mudx(|NUNUZ.AB2×LA|)	NUNUZ.AB2×LA
mudx(|NUNUZ.AB2×X|)	NUNUZ.AB2×X
mudx(|ZI&ZI.A|)	ZI&ZI.A
mudx(|ZI&ZI.EŠ2|)	ZI&ZI.EŠ2
mug	MUG
mug2	SAL
muga	MUG
mugux(MUG)	MUG
muh	U.KA
muh2	SAG×KAK
muh3	SAG×UB
muh4	SAG@g
muhaldim	MU
muhaldima	MU
muhhu	SAG@g
muiatix?(|PA.LAGABx(GUD+GUD)|)	PA.LAGABx(GUD+GUD)
muk	MUG
muk3	SAL
mul	ANx3
mul2	TE
mul3	HI×AŠ
mul4	U.GUD
mulla	BU
mullu	BU
mulu	ANx3
mulu4	GAN2.BU
mulu4-bu	GAN2.BU
mulugx(ŠIM)	ŠIM
mum	UMUM×KASKAL
mummun	KA×LI.KA×LI
mumun	KA×LI.KA×LI
mumunx(|KA×LI|)	KA×LI
mun	DIM×ŠE
mun2	UMUM×KASKAL
mun3	DIM
mun4	ŠEŠ
mun5	U.DIM×ŠE
mun6	U.DIM
munsub	MUNSUB
munsub2	SIK2.LAM.SUHUR
munsub3	GU2×NUN
munsub4	GU2@g
munsubx(PA)	PA
munsubx(|KA×SUHUR|)	KA×SUHUR
munsubx(|PA.GU2@g|)	PA.GU2@g
munsubx(|SIK2.SUHUR|)	SIK2.SUHUR
munu	DIM×ŠE
munu2	KI.NE
munu3	GA2×DIM×ŠE
munu4	PAP.PAP
munus	SAL
munussa	SAL.UŠ.DI
munux(|AB2.KU|)	AB2.KU
munux(|PAP.PAP×ŠE|)	PAP.PAP×ŠE
munuz	SAL
munx(|ANx3|)	ANx3
munx(|KA.HI.GA|)	KA.HI.GA
munx(|KA×LI|)	KA×LI
munzer	KI.AN.ŠEŠ.KI
munzerx(|MU.BU|)	MU.BU
munzerx(|SIG.MU.BU|)	SIG.MU.BU
munzur	KI.AN.ŠEŠ.KI
munšub	MUNSUB
munšub2	SIK2.LAM.SUHUR
muq	MUG
mur	HI×AŠ2
mur10	TUG2
mur2	NISAG
mur3	IM
mur6	KI.EN.KAK
mur7	MURGU2
mur8	MURGU2
murgišur	EZEN×A
murgišur2?	EZEN×X
murgu	SIG4
murgu2	MURGU2
murgu3	KA×NE
muri	NISAG
murim	IM
muru	HI×AŠ2
muru11	NINDA2×U2+AŠ
muru12	KID
muru13	UD@g
muru2	NISAG
muru3	IM
muru4	UR2×U2+AŠ
muru5	SAL.UD.EDIN
muru6	KI.EN.KAK
muru9	IM.DUGUD
murub	SAL
murub2	SAL.LAGAR
murub3	EN.ME.LAGAR
murub4	NISAG
murub5	SAL.UŠ.DAM
murub6	UD@g
murubx(|SAL.LAGAB|)	SAL.LAGAB
murubx(|UD×U+U+U@g|)	UD×U+U+U@g
murum	HI×AŠ2
murum11	NINDA2×U2+AŠ
murum4	UR2×U2+AŠ
murum5	SAL.UD.EDIN
murum6	KI.EN.KAK
murumx(|KA×HI×AŠ2|)	KA×HI×AŠ2
murumx(|TUR.SAL.TUR.TUR|)	TUR.SAL.TUR.TUR
murux(|KID.ŠU2.MA2|)	KID.ŠU2.MA2
murux(|UD×U+U+U@g|)	UD×U+U+U@g
murušx(GURUŠ)	GURUŠ
murx(UD@g)	UD@g
murx(|UD×U+U+U@g|)	UD×U+U+U@g
mussa	SAL.UŠ.DI
musub	MUNSUB
musub2	SIK2.LAM.SUHUR
musub3	GU2×NUN
musub4	GU2@g
musug2	U2.KA
musug4	U2.KUR.NI.TUK.KI
musug5	KA×U2
musur	KI.AN.ŠEŠ.KI
mut	HU.HI
mut2	BAD
muthum	U2.GIŠ.SAR
muwa	PA
muwati	PA
mux(HI)	HI
mux(|KA×GAN2@t|)	KA×GAN2@t
muya	PA
muyati	PA
muzer?	SIK2.LAM.SUHUR
muzir?	SIK2.LAM.SUHUR
muzug	U2.SAG
muzug2	U2.KA
muzug4	U2.KUR.NI.TUK.KI
muš	MUŠ
muš2	MUŠ3@g
muš3	MUŠ3
muš4	HI×AŠ
muš5	ŠEŠ
muš6?	BULUG
muš7	U.DAR
muš8	HU
muš9	MI
mušda	DIM2
mušdam	DIM2
mušdama	DIM2
mušdama2	MUŠ%MUŠ
mušen	HU
mušena	HU
muši	MI
mušku	MUŠ3
muškux(|MUŠ%MUŠ|)	MUŠ%MUŠ
muštaptin	BAHAR2
muštu	PI
muštu2	MU.UŠ.TUG2.PI
muštug	PI
muštug2	MU.UŠ.TUG2.PI
mušu	MI
mušx(|MUŠ%MUŠ|)	MUŠ%MUŠ
muššagana	LAGAB×MUŠ
muššagana2?	LAGAB×ŠITA@t+GIŠ
muţ	HU.HI
muţux(|HU.HI|)	HU.HI
na	NA
na2	NA2
na3	AK
na4	NI.UD
na5	ŠA
na6	LU2
na7	NAM
na8	KA×A
nab	AN&AN
nab3	AN.AN
nab4	IGI@g
nad	KUR
nad3	NA2
nag	KA×A
naga	NAGA
naga2	KA×A
naga3	GUM×ŠE
naga4	GUM
nagada	PA.DAG.KISIM5×KAK
nagadx(|AB2.KU|)	AB2.KU
nagal	LAGAR
nagar	NAGAR
nagara	NAGAR
nagargalx(|GAL.NAGAR|)	GAL.NAGAR
nagarx(BULUG)	BULUG
nagga	AN.NA
nagiri	KA×AD+KU3
nagx(KA)	KA
nagx(|URU×A|)	URU×A
nah	LUH
nah2	EŠ2
nak	KA×A
nak2	NAGA
nam	NAM
nam-ri	MUŠ3.ZA
nam2	NAM2
nam3	NIM
nam4	IGI@g
nama	NAGA
namma	LAGAB×HAL
nammax(|LAGAB×A|)	LAGAB×A
nammu	LAGAB×HAL
nammux(|LAGAB×A|)	LAGAB×A
namri	U2.KUR.ZA.MUŠ3@g.KI
namru	ZA.MUŠ3@g.DI
namx(|AN.AN|)	AN.AN
namx(|KA×A|)	KA×A
namšeše	TU
nan	ŠEŠ
nan2	ŠEŠ.KI
nan3	U.U.U
nanam	ŠA3×NE
nanam2	ŠA3×BAD
nanga	LAL2.LAGAB
nanga2	LAL.LAGAB
nanga3	LAL2.SAR
nanga4	LAL.SAR
nanga5?	AN.NA
nanga6	NAGA
nanibgal	AN.NAGA
nanibgal2	AN.ŠE.NAGA
nanna	ŠEŠ.KI
nanše	AB×HA
nap	AN&AN
nap2	ANx3
nappilu	NUN@t
naq	KA×A
nar	LUL
nar3	NUN&NUN
nari	LUL
nat	KUR
nat2	I
nata	KUR
nax(DU)	DU
nax(|HU.NA2|)	HU.NA2
nax(|UD.NI|)	UD.NI
nazi	AB×HA
naĝ	KA×A
naĝa	NAGA
naĝa3	GUM×ŠE
naĝa4	GUM
naš	U.U
naš?	MAŠ
našše	AB×HA
ne	NE
ne-ru	NE.RU
ne2	NI
ne3	PIRIG
ne4	ŠU2.NE
ne5	KI.NE
ne6	NA
ne7	NA2
ne8	NE@s
neda	PI
nehandix(|KA×GIŠ%GIŠ|)	KA×GIŠ%GIŠ
nem	NIM
nemerx(|NUN&NUN|)	NUN&NUN
nemur	KI.NE
nemurx(PIRIG)	PIRIG
nemurx(|PIRIG.TUR|)	PIRIG.TUR
nen	SAL.TUG2
nen9	SAL.KU
nenim	ŠA3×NE
nenin	KUR.SI.A.GA
nenkum	SAL.TUG2.PAP.IGI@g.NUN.ME.EZEN×KASKAL
nenna	LAGAB×U+U+U.LAGAB×U+U+U
nenna2	LAGAB×U+U+U
nenni	LAGAB×U+U+U.LAGAB×U+U+U
nenni2	LAGAB×U+U+U
nenni5	(ŠE.NUN&NUN)&(ŠE.NUN&NUN)
ner	NUN&NUN
nerah	MUŠ
nergal	PIRIG.AB@g.GAL
nerigal	PIRIG.AB@g.GAL
nes	U.U
nesag	NISAG
nesag2	ŠID
nesag3?	UD@g
nesaĝ	NISAG
nesaĝ2	ŠID
nesaĝx(|UD×U+U+U@g|)	UD×U+U+U@g
neš	U.U
neša	UR.MAH
ni	NI
ni-ir	NA2.X
ni10	LAGAB
ni11	UD@s.KID
ni2	NI2
ni3	GAR
ni4?	SAL.TUG2
ni5	NE
ni6	LAGAB.LAGAB
ni7	NIM
ni8	LI
ni9	U.UD.KID
nib	PIRIG×KAL
nibri	EN.KID
nibru	EN.KID
nid	UŠ
nida	GU2.NUNUZ
nida2	NINDA2
nidaba	ŠE.NAGA
nidaba2	NAGA
nidalam	SAL.UŠ.DAM
nidalam2	UŠ.DAM
nidalam3	UŠ.SAL.DAM
nidalam4	SAL.UŠ
nidba	PAD.AN.MUŠ3
nidba2	PAD.MUŠ3
nidlam	SAL.UŠ.DAM
nidlam2	UŠ.DAM
nidlam3	UŠ.SAL.DAM
nidlam4	SAL.UŠ
nieš	NIGIDAEŠ
nig	SAL.UR
nig2	GAR
nig6	U.UD.KID
niga	ŠE
nigan	ŠE
nigar	U.UD.KID
niggi	AN.NA
niggin	AN.NA
nigginaku	LAGAB.LAGAB
niggix(|LAGAB.LAGAB|)	LAGAB.LAGAB
nigi	LAGAB.LAGAB
nigi2	LAGAB
nigi3	NUNUZ.DIM2
nigida	DIŠ
nigidaeš	NIGIDAEŠ
nigidalimmu	NIGIDALIMMU
nigidamin3	NIGIDAMIN
nigin	LAGAB.LAGAB
nigin10	UD@s.KID
nigin11	LAGAB×UŠ
nigin2	LAGAB
nigin3	U.UD.KID
nigin4	U.UD
nigin5	LAL2.LAGAB
nigin6	AB×HA
nigin7	LAL.LAGAB
nigin9	LAL.SAR
niginx(|LAGAB×LAGAB|)	LAGAB×LAGAB
niginx(|U.KID|)	U.KID
niginx(|UD.KID|)	UD.KID
niginx?(|AB×LAGAB|)	AB×LAGAB
nigir	DUN3@g@g
nigir2	DUN4
nigir3	EN%EN
nigix(GAR)	GAR
nigru	KA×AD+KU3
nigu	ŠE
nigx(UR)	UR
nigx(ŠE)	ŠE
nik	SAL.UR
nik2	GAR
nik5	KA×A
nika	PEŠ2
nilimmu	NIGIDALIMMU
nim	NIM
nim2	SAL.TUG2
nim3?	U.UD
nim4?	LUM
nim5	GAR
nima	NIM
nimbar	ŠA6
nimem3	LAL.LAGAB
nimen	LAL2.LAGAB
nimen2	LAGAB
nimen4	LAL2.SAR
nimen5	LAL.SAR
nimenx(|LAGAB.LAGAB|)	LAGAB.LAGAB
nimenx(|LAGAB×UŠ|)	LAGAB×UŠ
nimgigre	IM%IM
nimgigri2	EN%EN.IM%IM
nimgigri?	EN%EN
nimgin3?	U.UD.KID
nimgir	DUN3@g@g
nimgir2	DUN4
nimgirgirri	EN%EN
nimgirgirri2	EN%EN.IM%IM
nimin3	NIGIDAMIN
niminx?(NAGAR)	NAGAR
nimirx(DUN3@g@g)	DUN3@g@g
nimur	KI.NE
nimurx(|PIRIG.TUR|)	PIRIG.TUR
nin	SAL.TUG2
nin10	SAL.SIK2
nin3	LAGAB.LAGAB
nin4	LAGAB
nin6	GAR
nin7	LAGAB×U+U+U.LAGAB×U+U+U
nin9	SAL.KU
nina	AB×HA
nina2	DARA4
nina3	SAL.TUG2
ninagal	UMUM×KASKAL
ninda	GAR
ninda2	NINDA2
ninda3	LAGAB×IM
ninda4?	LAGAB×GAR
nindaba	PAD.AN.MUŠ3
nindabax(|PAD.AN.MUŠ2|)	PAD.AN.MUŠ2
nindabax(|PAD.MUŠ3|)	PAD.MUŠ3
nindamekar	NINDA2×ME+GAN2@t
nindan	GAR
nindar	SI.A
nindu	LAGAB×GAR
nindu2	LAGAB×IM
ningi	ŠIM
ningi2	ŠIM×A
ningi3	ŠIM×GAR
ningin3	U.UD.KID
ningin4	U.UD
nini	LAGAB.LAGAB
ninim	ŠA3×NE
ninindu	LAGAB×GAR
ninindu2	LAGAB×IM
ninir	NUN&NUN
ninkum	SAL.TUG2.PAP.IGI@g.NUN.ME.EZEN×KASKAL
ninmuš	LAGAB×TAK4
ninna	LAGAB×U+U+U.LAGAB×U+U+U
ninna2	LAGAB×U+U+U
ninnax(DARA4)	DARA4
ninni2	LAGAB.LAGAB
ninni3	GAR
ninni4	LAGAB×U+U+U
ninni5	(ŠE.NUN&NUN)&(ŠE.NUN&NUN)
ninni6?	MUŠ3
ninni7	PAD.AN.MUŠ3
ninni8	ŠE.NUN&NUN
ninnim4	LAGAB×U+U+U
ninnim7	PAD.AN.MUŠ3
ninnimx(|PAD.MUŠ3|)	PAD.MUŠ3
ninnix(|PAD.MUŠ3|)	PAD.MUŠ3
ninnix(|U&U.U&U.U|)	U&U.U&U.U
ninnu	U&U.U&U.U
ninnu2	LAGAB×U+U+U.LAGAB×U+U+U
ninnux(|LAGAB×U+U+U|)	LAGAB×U+U+U
ninta	UŠ
nintah	UŠ
nintah2	ARAD
nintah3	SAL.UŠ
nintahu	UŠ
nintax(ARAD)	ARAD
nintax?(ARAD)	ARAD
ninux(|U&U.U&U.U|)	U&U.U&U.U
ninx(|PA.TE|)	PA.TE
ninx(|SAL.EŠ2|)	SAL.EŠ2
niq	SAL.UR
niq2	GAR
niqix(GAR)	GAR
nir	NUN&NUN
nir2	ZA.DUN3@g
nir3	ZA.NIM
nir4	ZA.SU
nir5	ZA.IB
nir6	KAL
nir7	ZA.DUN3@g@g
nira	NUN&NUN
nira2	ZA.KUR
nira3	ZA.NIM
nirah	MUŠ
nirx(DUN@g)	DUN@g
nirx(|DUN3@g@g.ZA|)	DUN3@g@g.ZA
nis	U.U
nisaba	ŠE.NAGA
nisaba2	NAGA
nisag	NISAG
nisag2	ŠID
nisag3?	UD@g
nisaga	NUNUZ.KISIM5
nisagga	NUNUZ.AB2
nisax?(SAR)	SAR
nisaĝ	NISAG
nisaĝ2	ŠID
nisaĝx(|UD×U+U+U@g|)	UD×U+U+U@g
nisig	SAR
nisikix(|GAR.GAD.TAK4.UR2|)	GAR.GAD.TAK4.UR2
nisikix(|GIŠ.GAR.UMBIN|)	GIŠ.GAR.UMBIN
nisix?(SAR)	SAR
nisku	PIRIG
nissa	SAR
nit	UŠ
nita	UŠ
nita2	ARAD
nita3	SAL.UŠ
nita4	GAR
nitadam2	UŠ.DAM
nitah	UŠ
nitah2	ARAD
nitah3	SAL.UŠ
nitahu	UŠ
nitalam	SAL.UŠ.DAM
nitalam2	UŠ.DAM
nitalam3	UŠ.SAL.DAM
nitalam4	SAL.UŠ
nitax(|ARAD×KUR|)	ARAD×KUR
nitax(|UŠ.KU|)	UŠ.KU
nitlam	SAL.UŠ.DAM
nitlam2	UŠ.DAM
nitlam3	UŠ.SAL.DAM
nitlam4	SAL.UŠ
nittax(UŠ)	UŠ
niĝ	SAL.UR
niĝ2	GAR
niĝ6	U.UD.KID
niĝar	U.UD.KID
niĝi2	LAGAB
niĝin	LAGAB.LAGAB
niĝin2	LAGAB
niĝin3	U.UD.KID
niĝin5	LAL2.LAGAB
niĝin6	AB×HA
niĝin8	LAL2.SAR
niĝin9	LAL.SAR
niĝinx(BULUG)	BULUG
niĝir	DUN3@g@g
niĝirgalx(|GAL.DUN3@g@g|)	GAL.DUN3@g@g
niš	U.U
niš2	GIŠ
niša	SAR
niţ	UŠ
nu	NU
nu10	KU
nu11	NU11
nu12	LU
nu13	HI×NUN
nu2	NA2
nu3	NIM
nu4	LUM
nu5	KUL
nu6	NUN
nu7	AB@g
nu8	NA
nu9?	LI
nud	NA2
nug	ŠIM×MUG
nug2	ŠIM×DIN
nugx(ŠIM)	ŠIM
num	NIM
num2	LUM
numdu	KA×NUN
numdum	KA×NUN
numdun	KA×NUN
numgišur	EZEN×A
numma	ŠIR&ŠIR.BUR&BUR
numu	KUL
numun	KUL
numun2	ZI&ZI.LAGAB
numun3	HI×NUN
numunx(|A.ZI&ZI|)	A.ZI&ZI
numunx(|ZI&ZI.A|)	ZI&ZI.A
numunx(|ZI&ZI.EŠ2|)	ZI&ZI.EŠ2
numx(NU11)	NU11
nun	NUN
nun2	A.HA.TAR.KAK
nun3	BU
nuna	NUN
nundu	KA×NUN
nundum	KA×NUN
nundun	KA×NUN
nungi	ŠIM
nungi2	ŠIM×A
nungi3	ŠIM×GAR
nunmeli	BAR.HU.KAK
nunpe	NUN@t.KI
nunpex(|NUN.KI|)	NUN.KI
nunu	NUNUZ
nunun	NUN
nunurra	BAHAR2
nunurru	BAHAR2
nunus	NUNUZ
nunusx(SAL)	SAL
nunuz	NUNUZ
nunuzzi	EN.NUNUZ.ZI.AN.UD
nunx(NE)	NE
nur	NUN&NUN
nura	ERIN2
nuri	ERIN2
nurra?	LUGAL
nuru	ERIN2
nurx(NU11)	NU11
nus	NUNUZ
nuska	PA.TUG2
nuska2	PA.LU
nusku	PA.TUG2
nusku2	PA.LU
nussu	LAGAB×U+U+U
nux(|AB×U+U+U|)	AB×U+U+U
nux(|HU.NA2|)	HU.NA2
nux(ŠITA)	ŠITA
nuz	NUNUZ
nuzzi	EN.NUNUZ.ZI.AN.UD
nuĝun	KUL
nuĝx(NUN)	NUN
nuška	PA.TUG2
nuška2	PA.LU
nušku2	PA.LU
nūr-ili	URU×IGI
pa	PA
pa10	IGI
pa12	PI
pa2	BA
pa3	IGI.RU
pa4	PAP
pa5	PAP.E
pa6	PAP.IŠ
pa7?	HU
pa8	ŠID
pa9	ŠA6
pab	PAP
pad	PAD
pad2	BAD
pad3	IGI.RU
pad4	IGI
pad5	PAP.E
pad6	PAP.IŠ
pada	PAD
pag	HU
pagra3	LU2×4
pagrax(|LU2.LU2.LU2.LU2|)	LU2.LU2.LU2.LU2
pagrax(|LU2@LU2|)	LU2@LU2
pah	LUL
pah3	HU
pak	HU
pal	BAL
pala	NAM.LUGAL
pala2	NAM.EN
pala3	NAM.SAL.TUG2
pala4	BAL
palil	IGI.DU
palil2	IGI.EŠ2.DU.ERIN2
pallilx(|IGI.EŠ2.DU.ERIN2|)	IGI.EŠ2.DU.ERIN2
pan	PAN
pan2?	LUL
pan3	IGI
pana	PAN
panax(|ŠE.NUN&NUN|)	ŠE.NUN&NUN
panu	ZA.MUŠ3@g.AB@g
panšur	URU×URUDA
pap	PAP
pap-ugur2	PAP.IGI@g
papa2	KA2
papnun	LAL2
paq	HU
par	UD
par2	BAR
par3	DAG
par4	NI.GIŠ
par5	ERIN2
par6	BARA2
para	UD
para10	BARA2
para2	BAR
para3	DAG
para4	NI.GIŠ
para5	LAGAB×EN
para6	LAGAB×ME+EN
para7	LAGAB×IGI@g
para8	LAGAB×TAK4
para9	LAGAB×LUL
parag	BARA2
parim	PA.DU@s
parsa	KUR.TI
pat	PAD
pat2	BAD
pata	PAD
patru	GIR2
pax(BAD)	BAD
pax(IDIM)	IDIM
pax(PAD)	PAD
pax(|DAG.KISIM5×KAK|)	DAG.KISIM5×KAK
pax(|E×PAP|)	E×PAP
paţ	PAD
paţ2	BAD
pe	PI
pe2	BI
pe3	BAD
pe4?	KA
pe5	NE
pel	NE
pel2	NE@s
pel5	NUNUZ
peš	HA@g
peš10	KI.A
peš11	HA
peš12	UD
peš13	ŠA3×TUR
peš14	ŠU.KAD4
peš2	PEŠ2
peš3	MA
peš4	ŠA3×A
peš5	KAD4
peš6	KAD5
peš7	TUR
peš8?	ŠU.GAN
peš9	UD.A
pešx(LAK171@s)	LAK171@s
pešx(|GA.KAD3|)	GA.KAD3
pešx(ŠA3)	ŠA3
pešše	MA
pi	PI
pi2	BI
pi3	BAD
pi4	KA
pi5	NE
pi7?	GA2×A+IGI
pi8	BU
pih?	LUL
pihu	BI.U2.SA
pihu2	NUNUZ.AB2×BI
pihu3	BI.UŠ.SA
pihu3?	KA.KAK
pihu4	BI.U2.SA
pihu5	UŠ.SA
pihu6	NUNUZ.AB2×IGI@g
pihux(|U2.SA.KA.KAK|)	U2.SA.KA.KAK
pihux(|U2.SA|)	U2.SA
pik	SIG
pil	NE
pil2	NE@s
pil3	GIŠ.NE@s
pil4	GIŠ.NE
pil6?	NU11
pil7	PIRIG
pin	APIN
piq	SIG
pir	UD
pir2	ERIN2
pir3	HI×ŠE
pir6	NAM
pirig	PIRIG
pirig2	UD
pirig3	PIRIG×UD
piriga	PIRIG
piriĝ	PIRIG
piriĝ2	UD
piriĝ3	PIRIG×UD
piriĝa	PIRIG
piru?	GA2×A+IGI
pis	HA@g
pisag	GA2
pisag2	ŠID
pisag3	ŠID×A
pisagx(|GA2×GI4|)	GA2×GI4
pisagx(|GA2×GI|)	GA2×GI
pisan	GA2
pisan2	ŠID
pisan3	ŠID×A
pisanx(|GA2×GI4|)	GA2×GI4
pisanx(|GA2×GI|)	GA2×GI
pisaĝ	GA2
pisaĝ2	ŠID
pisaĝ3	ŠID×A
pitru	GABA
piš	HA@g
piš10	KI.A
piš2	PEŠ2
piš4	ŠA3×A
piš5	KAD4
piš6	KAD5
piša	HA@g
pišx(LAK171@s)	LAK171@s
piţ	E2
pu	BU
pu-udu	KA×LU
pu11	U2
pu2	LAGAB×U
pu3	KA×GAN2@t
pu5	KA
pu6	LAGAB×BAD
puginx(LAGAB×A)	LAGAB×A
puginx(|LAGAB×A|)	LAGAB×A
puglu	ŠA3.GI
puh	LUL
puhrum	GIŠ%GIŠ
puk	MUG
pul	LAGAB×U+U+U
pul2	BUR2
pul3	BAL
pum	KA×GAN2@t
puq2	HU
pur	BUR
pur13	PAP.PAP
puru	BUR
pus	HA@g
puta	ZAG
pute	ZAG
puti	ZAG
putu	ZAG
puzru	KA×GAN2@t.ŠA
puzur	U
puzur2	U.U
puzur3	U.ZAG
puzur4	KA×GAN2@t.ŠA
puzur5	KA×GAN2@t
puš2	PAP.HAL
puš3	HA@g
puš4	DUN3@g
qa	SILA3
qa2	GA
qa3	KA
qa4	ŠU.MIN
qa6	KAK
qab	GABA
qab2	KAB
qablu	UZ3×KASKAL
qad	ŠU
qad2	ŠU.MIN
qad3	GAD
qad6?	KAD2
qadma	GUD
qadmax(TAR)	TAR
qadmu	TAR
qal	GAL
qal3	URU×MIN
qal4	KAL
qam	GAM
qam2	HI×BAD
qan	GAN
qan2	GI
qap	GABA
qap2	KAB
qaptu	DUGUD
qaq	KAK
qaqqaru	KI
qar	GAR3
qar2	TE.A
qar3?	GAR
qara3?	GAR
qat	ŠU
qat2	ŠU.MIN
qat3	GAD
qat5	KAD4
qat6?	KAD2
qat7?	KAD3
qat8	KAD5
qata	ŠU
qati	ŠU.MIN.ME.U.U.U
qe	KIN
qe2	KI
qe3	GI
qe4	GI4
qer5	GAR3
qi	KIN
qi2	KI
qi3	GI
qi4	GI4
qi5	KID
qi6	KAK
qib	GIŠ%GIŠ
qid	KID
qid2	BU
qid4?	GAD
qil	LAGAB
qil2	GI%GI
qili2?	GI%GI
qim	DIM2
qin	KIN
qip	GIŠ%GIŠ
qiq	GIG
qir	HA@g
qir3	LAGAB
qir6	AB2×GAN2@t
qir7	GIR3
qiri	HA@g
qis	KIŠ
qit	KID
qit2	BU
qit3	BAD
qiš	KIŠ
qišat	ŠE.NUN&NUN
qišatx(|GIŠ×TAK4|)	GIŠ×TAK4
qu	GUM
qu2	KU
qu3	GU
qu5	KU3
qu6	GU2
qub	DU
qud	TAR
qudma	TAR
qudmax(GUD)	GUD
qudmu	TAR
qul	KUL
qul2	GUL
qum	GUM
qum2	NE
qum3	LUM
qumx(TAR)	TAR
qun	KUN
qup	DU
qup2?	HUB2×UD
qur	GUR
qur2	KUR
qur3?	GAM
qur4	PAP
qurx(TE@g)	TE@g
qut	TAR
qutra	KI.AN.IM
qutu	TAR
qû	SILA3
ra	RA
ra2	DU
ra3	UD
ra4	SUD2
ra5?	BU
ra6	AK
rab	RAB
rab2	GAL
rab3?	LUGAL
rab4?	KAL
raba	RAB
rabita	EDIN
rabx(NUN)	NUN
rad	SUD2
rag	SAL
ragab3	KAB.UŠ
ragabx(|DA.UŠ|)	DA.UŠ
rah	LUH
rah2	RA
rahx(|DU&DU.DU&DU|)	DU&DU.DU&DU
rahx(|DU.DU.DU.DU|)	DU.DU.DU.DU
rahx(|DU.DU|)	DU.DU
rahx(|DU@s.DU@s|)	DU@s.DU@s
rak	SAL
ram	NINDA2×NE
ram2	AŠ
rama	NINDA2×NE
raman	KUR
ramanu	KUR
rap	RAB
rap2?	GAL
rapiku	DAG.KISIM5×PAP+PAP
rapiqu	DAG.KISIM5×PAP+PAP
rapiqu2	IDIM
raq	SAL
ras	KASKAL
rat	SUD2
rata	SUD2
rax(DU@s)	DU@s
rax(|U.GUD|)	U.GUD
rax?(IGI)	IGI
razu	KUR
raš	KASKAL
raš2	TUK
rašu	KUR
raţ	SUD2
re	RI
re'e	PA.LU
re'i	PA.LU
re'u	PA.LU
re12?	KAK
re2	URU
re3	LAGAB
re6	DU
re7	DU&DU
re8	MUŠ%MUŠ
rem2	AB2
reme	LAGAB
reme2	AB2
rex(|DU&DU.DU&DU|)	DU&DU.DU&DU
rex(|DU.DU.DU.DU|)	DU.DU.DU.DU
rex(|DU@s.DU@s|)	DU@s.DU@s
ri	RI
ri...	TUM
ri10?	EDIN
ri12?	KAK
ri2	URU
ri3	LAGAB
ri4	ZUM
ri5	NUN&NUN
ri6	DU
ri7	DU&DU
ri8	MUŠ%MUŠ
ri9	LU2@s
rib	KAL
ribx(EDIN)	EDIN
rid	MES
rig	ŠIM
rig10	PA.DAG.KISIM5×KAK
rig11	MES.RU
rig12	DU.HUB2
rig2	ZUM
rig3	ŠITA2
rig5	RI
rig6?	SAL.LAGAB×AŠ2
rig7	PA.HUB2.DU
rig8	PA.HUB2
rig9	HUB2.DU
rige12	DU.HUB2
rigx(|PA.TUK.DU|)	PA.TUK.DU
rigx(|ŠID.RU|)	ŠID.RU
rih	LUH
rik	ŠIM
rik2	ZUM
rik4	ŠEN
rim	LAGAB
rim2	AB2
rim3	NE.RU
rim4	DU@s
rim5	AŠ
rimu2	AB2
rimx(ZUM)	ZUM
rimx(|RU.NE|)	RU.NE
rin	LAGAB
rin2	ERIN2
rin3	LAGAB.LAGAB
rin4	MUŠ%MUŠ
rin5	LU2@s
rin6	KASKAL
rina2	ERIN2
rip	KAL
riq	ŠIM
riq2	ZUM
ririg	PA.DAG.KISIM5×KAK
ris	SAG
rit	MES
rit2	SUD2
riš	SAG
riţ	MES
ru	RU
ru10	TE@g
ru11	URU×GAN2@t
ru12	EN
ru13	EN×GAN2@t
ru14	URU×A
ru2	KAK
ru3	AŠ
ru4	URU×UD
ru5	U.GUD
ru6	EDIN
ru7	UR
ru8	TA×HI
ru9	URU
rub	KAL
rud	SUD2
rug	ŠEN
rug2	NAM.SU
ruh	LUH
ruh2	LU2
ruk	ŠEN
rum	AŠ
rum2	NE.RU
rum3?	NIM
ruq	ŠEN
ruqu	ŠEN
ruš?	HI.GIR3
rušban	GUD
rušpan	GUD
ruţ	SUD2
rābişu	UDUG
rēšu	SAG
sa	SA
sa10	NINDA2×ŠE
sa11	SI@g
sa12	SAG
sa13	IGI.ERIN2
sa14	KAL
sa15?	GAR
sa16	UD
sa17	ŠU2.NAGA
sa18	BI
sa19	ŠA
sa2	DI
sa21	ŠEG9
sa3	ZA
sa4	HU.NA2
sa5	SI.A
sa6	ŠA6
sa7	IGI@g
sa7-alan	IGI@g.ALAN
sa8	AN
sa9	MAŠ
sab	PA.IB
sabad	GA2×U
sabad2	GA2×BAD
sabad3	GA2×IGI@g
sabar	ŠEG9.BAR
sabu	SI.A.BUR2
sad	KUR
sad2	GA2×U
sad3	GA2×BAD
sad4	GA2×IGI@g
sadu	DI.DI
sadx(|E2×U|)	E2×U
sag	SAG
sag10	IGI.ERIN2
sag11	KIN
sag12	IGI@g
sag2	PA.GAN
sag3	PA
sag4	LUGAL
sag5	NISAG
sag7	GAN
sag8	KAL
sag9	ŠA6
saga	SAG
saga11	KIN
sagax(|ŠE.KIN.KIN|)	ŠE.KIN.KIN
sagax(|ŠE.KIN|)	ŠE.KIN
sagbar	HI×AŠ2
sagdu?	SAG×DU
sagdudu	LAGAB×ŠITA@t+GIŠ
sagdudux(|LAGAB×ŠITA+GIŠ+ERIN2|)	LAGAB×ŠITA+GIŠ+ERIN2
sagdul	U.SAG
sagga	ŠID
sagga2	IL2.MA2.DUB2
sagga3	IL2.MA2.IGI@g
sagga4	IL2.DUB2
sagga5	GA.UZ3.IGI@g
sagga6	GA.MA2.IGI@g
saggar	SAG
saggar2	HI×AŠ2
sagi	SILA3.ŠU.GABA
sagix(|SILA3.GABA|)	SILA3.GABA
sagix(ŠU)	ŠU
sagkurini?	DUB2
sagkurun	DIN.KASKAL.U@g.DIŠ
sagman	MAŠ.U.U
sagmaš	BAD.KASKAL
sagmin	MAŠ.U.U
sagminx(|SAG&SAG|)	SAG&SAG
sagmunzer	SIK2.MU.BU
sagmunzir	SIK2.MU.BU
sagtag	AŠ
sagtag3	AŠ@z
sagtak	AŠ
sagtak3	AŠ@z
sagtušx(|U.SAG|)	U.SAG
sagus	UD.DU
saguš	UD.DU
sagx(UD@g)	UD@g
sagx(|U.GA|)	U.GA
sagx(ŠE)	ŠE
sagšu	U.SAG
sah	KID
sah2	ŠUBUR
sah3?	DUN
sah4	GU%GU
sah6	HA.A
sah7	A×HA
saha6	HA.A
saha7	A×HA
sahab	ŠU.DIŠ
sahab2	ŠU.DI.U.U.U
sahabx(|ŠU.SI.DI|)	ŠU.SI.DI
sahan?	MUŠ
sahar	IŠ
sahar2	SAR
sahardub	IŠ
sahx(KU)	KU
sahx(|A.HA.A|)	A.HA.A
sahx(|A.HA|)	A.HA
sak	SAG
sak3	PA
sak6	ZAG
sakar	SAR
sakarx(NU11)	NU11
sakkan	GIR3
sakkan2	GIR3.GA2×PA.A.AN
sal	SAL
sal2	DI
sal3	NI
sal4	SILA3
sala	SAL
sala4	SILA3
salagud	DI
salah	UD
salamx(|IGI@g.ALAN|)	IGI@g.ALAN
salgud	DI
salim	DI
salubug2	DIŠ
salugub	AŠ
salugub2	DIŠ
sam	U2
sam2	NINDA2×ŠE
samag	UM
samag2	UM×ŠA3
samag3	UM×U
samag4	UM×U.LAGAB
samag5	UM×LAGAB
samag6	IGI@g
samagx(|UM.LAGAB|)	UM.LAGAB
samagx(|URUDA×U.LAGAB|)	URUDA×U.LAGAB
samagx(|URUDA×U.U|)	URUDA×U.U
samagx(|URUDA×U|)	URUDA×U
saman	EŠ2.SUD.NUN.EŠ2.TU
saman2	EŠ2.BU.NUN.EŠ2.TU
saman3	ŠE.EŠ2.NUN.BU
saman4	U.GAN
saman5	NUNUZ.AB2×AŠGAB
samanurx(|EŠ2.BU.NUN.EŠ2.TU|)	EŠ2.BU.NUN.EŠ2.TU
samanurx(|EŠ2.SUD.NUN.EŠ2.TU|)	EŠ2.SUD.NUN.EŠ2.TU
samanx(EŠ2)	EŠ2
samanx(|A.PA.BI.SI.A.GA|)	A.PA.BI.SI.A.GA
samanx(|A.PA.GISAL.PAD.SI.A|)	A.PA.GISAL.PAD.SI.A
samanx(|BU.NUN.ŠE.EŠ2|)	BU.NUN.ŠE.EŠ2
samanx(|GISAL.PAD.SI.A|)	GISAL.PAD.SI.A
samanx(|KU.BU.NUN.TU.KU|)	KU.BU.NUN.TU.KU
samanx(|NUN.ŠE.LAL|)	NUN.ŠE.LAL
samanx(|SUD.NUN.EŠ2.TU|)	SUD.NUN.EŠ2.TU
samanx(|SUD.NUN.ŠE.EŠ2|)	SUD.NUN.ŠE.EŠ2
samanx(|TUG2.BU.TUG2.TU|)	TUG2.BU.TUG2.TU
samun+	EŠ2.SUD.NUN.EŠ2.TU
samx(SAG)	SAG
samx(|NINDA2×AN|)	NINDA2×AN
samx(|NINDA2×ŠE+A+AN|)	NINDA2×ŠE+A+AN
samx(|NINDA2×ŠE+A.AN|)	NINDA2×ŠE+A.AN
samx(|NINDA2×ŠE+A|)	NINDA2×ŠE+A
samx(|NINDA2×ŠE.A.AN|)	NINDA2×ŠE.A.AN
samx(|NINDA2×ŠE.A|)	NINDA2×ŠE.A
san	SAG
san2	ŠEN
san3	NINDA2×AN
sandak4	DIŠ
sanga	ŠID
sanga2	SANGA2
sanga3	IL2.MA2.IGI@g
sanga4	IL2.DUB2
sanga5	GA.UZ3.IGI@g
sanga6	GA.MA2.IGI@g
sangax(|GA.UZ3.HI|)	GA.UZ3.HI
sangax(|GA.UZ3|)	GA.UZ3
sangu	ŠID
sangu2	IL2.MA2.DUB2
sangu3	IL2.MA2.IGI@g
sangu4	IL2.DUB2
sangu5	GA.UZ3.IGI@g
sangu6	GA.MA2.IGI@g
santa	AŠ
santa4	DIŠ
santag	AŠ
santag4	DIŠ
santak	AŠ
santak2	AŠ@k
santak3	AŠ@z
santak4	DIŠ
santan	GAL.NI
santana	GAL.NI
sap	PA.IB
sap2	ERIN2
sap3	PA.LU
saparu?	LU2.ME.EN
saq	SAG
sar	SAR
sar2	ŠAR2
sar3	NI
sar4	SUD
sar5	MUŠ3
sar6	LAGAB×SUM
sar7	LUL
sar8	SUM
sara	SAR
sara2	ŠAR2
sare2	ŠAR2
sargad	HI×GAD
sarix(SAR)	SAR
sarsa	SAR.SAR
sarx(NU)	NU
sarx(|A.LAGAB×KUL|)	A.LAGAB×KUL
sas	ŠEŠ
sasx(KI)	KI
sat	KUR
sata	KUR
sax(NISAG)	NISAG
sax(ZAG)	ZAG
sax(|GU%GU|)	GU%GU
sax(|NINDA2×AN|)	NINDA2×AN
sax(|NINDA2×AŠ+AŠ|)	NINDA2×AŠ+AŠ
sax(|NINDA2×ŠE+A+AN|)	NINDA2×ŠE+A+AN
sax(|NINDA2×ŠE+A.AN|)	NINDA2×ŠE+A.AN
sax(|NINDA2×ŠE+A|)	NINDA2×ŠE+A
sax(|NINDA2×ŠE+AŠ+AŠ|)	NINDA2×ŠE+AŠ+AŠ
sax(|NINDA2×ŠE+AŠ|)	NINDA2×ŠE+AŠ
sax(|NINDA2×ŠE.A.AN|)	NINDA2×ŠE.A.AN
sax(|NINDA2×ŠE.A|)	NINDA2×ŠE.A
saĝ	SAG
saĝ4	LUGAL
saĝ5	NISAG
saĝa	SAG
saĝa2	SANGA2
saĝa3	IL2.MA2.IGI@g
saĝa4	IL2.DUB2
saĝa5	GA.UZ3.IGI@g
saĝa6	GA.MA2.IGI@g
saĝa7	GA.BALAG
saĝa8	ŠID
saĝax(|GA.UZ.IGI@g|)	GA.UZ.IGI@g
saĝax(|GA.UZ3.HI|)	GA.UZ3.HI
saĝax(|GA.UZ3|)	GA.UZ3
saĝax(|LAGAB×LAK175|)	LAGAB×LAK175
saĝdudux(|LAGAB×ŠITA@t|)	LAGAB×ŠITA@t
saĝmaš	BAD.KASKAL
saĝmin	MAŠ.U.U
saĝminx(|SAG&SAG|)	SAG&SAG
saĝtak	AŠ
saĝtak2	AŠ@k
saĝtak3	AŠ@z
saĝtak4	DIŠ
saĝx(|UD×U+U+U@g|)	UD×U+U+U@g
saĝĝa	ŠID
saĝĝa2	IL2.MA2.DUB2
saĝĝar	SAG
saĝĝar2	HI×AŠ2
saĝšu	U.SAG
se	SI
se10	ZA.MUŠ3.DI
se11	SIG
se12	IGI@g
se15	SAR
se2	ZI
se20	ZE2
se24	A.MUŠ3
se25	MUŠ3.DI
se26	A.MUŠ3.DI
se27	MUŠ3
se28	MUŠ3@g
se3	SUM
se8	DI
se9	MUŠ3×A+DI
sed	MUŠ3×A+DI
sed3	A.MUŠ3
sed4	MUŠ3.DI
sed5	A.MUŠ3.DI
sed6	MUŠ3
sed7	MUŠ3@g
sed8	ZA.MUŠ3.DI
sedi	MUŠ3×A+DI
sedi3	A.MUŠ3
sedi4	MUŠ3.DI
sedi6	MUŠ3
sedi7	MUŠ3@g
sedi8	ZA.MUŠ3.DI
sedx(A)	A
sedx(|MUŠ3×DI|)	MUŠ3×DI
seg	SIG
seg10	SUM
seg11	PA.GAN
seg14	ŠEG9
seg15	KAL
seg16	GAN
seg17	GI
seg18	KIN
seg2	SIK2
seg3	PA
seg4	SIG4
seg5	IGI.ERIN2
seg6	ŠA6
seg7	IGI@g
seg8	GAD.TAK4.GIŠ
seg9	SI
segga	ŠEG9
ser3	EZEN
sermuššu?	IGI@g.TAK4.ALAN
ses	ŠEŠ
sex(|MUŠ3×DI|)	MUŠ3×DI
si	SI
si11	SIG
si12	IGI@g
si13	NAM
si14	DUG
si15	SAR
si17	IGI
si18	KA×BALAG
si19	KA×UD
si2	ZI
si20	ZE2
si21	KAL
si22	GI
si23	GUL
si29	PA
si3	SUM
si4	SI@g
si5	IGI.EŠ2
si6	LU
si7	UMUM×KASKAL
si8	DI
sib	ME
sib2	PA.LU
siba	PA.LU
sibad	PA.LU
sibir	U.EN×GAN2@t
sibsib	KA×ME+ME
sid	MUŠ3×A+DI
sid2	ŠID
sidra	EZEN
sidug	LAGAB×DAR
sidug2	LAGAB×GA
siduga2	LAGAB×GA
sidugax(|LAGAB×TAG|)	LAGAB×TAG
sidugga	LAGAB×DAR
sidugga2	LAGAB×GA
sig	SIG
sig10	SUM
sig11	PA.GAN
sig14	ŠEG9
sig15	KAL
sig16	GAN
sig17	GI
sig18	KIN
sig2	SIK2
sig3	PA
sig4	SIG4
sig5	IGI.ERIN2
sig6	ŠA6
sig7	IGI@g
sig8	GAD.TAK4.GIŠ
sig9	SI
siga	SIG
siga18	KIN
sigax(|ŠU2.NAGA|)	ŠU2.NAGA
sigga	ŠEG9
sigga2	PA
sigx(KA)	KA
sigx(KA×BALAG)	KA×BALAG
sigx(KA×ŠID)	KA×ŠID
sigx(SAR)	SAR
sigx(UMBIN)	UMBIN
sigx(|KA×BALAG|)	KA×BALAG
sigx(|KA×ŠID|)	KA×ŠID
sigx(|URU×TU|)	URU×TU
sigx(|ŠE.KIN|)	ŠE.KIN
sih	ŠUBUR
sih2	KID
sih4	MUŠ3@g
sih5	GU%GU
sik	SIG
sik10	SUM
sik2	SIK2
siki	SIK2
siki2	UD
sikil	EL
sikin	SIK2.LAM
sikix(|PA.GAN|)	PA.GAN
sil	TAR
sil10	EZEN×UD
sil2	NUN
sil3	SILA3
sil4	MI
sil5	EZEN×KASKAL
sil6	EZEN×A
sil7	EZEN×A+LAL
sil8	ŠIR
sil9	EZEN×A+LAL2
sila	TAR
sila11	ŠID
sila3	SILA3
sila4	GA2×PA
silag	ŠID
silaku	GA2×PA
silal	EZEN×A
silalx(|EZEN×KU3|)	EZEN×KU3
silaĝ	ŠID
silig	URU×IGI
silig2	TAG×UD
silig3	TAG×TUG2
silig4	TAG×GUD
silig5	URU×URUDA
silig6	KA×ŠID
silim	DI
silim2	KAL
silima	DI
silima2	KAL
silix(DI)	DI
sillal	EZEN×UD
silx(EZEN)	EZEN
silx(|EZEN×LAL2|)	EZEN×LAL2
sim	NAM
sim2	SUM
sim3	DI
sim4?	LAGAB
sim5	ZUM
simed	AŠ
simig	DUB
simug	UMUM
simuggalx(|GAL.UMUM|)	GAL.UMUM
simx(GIG)	GIG
simx(|KA×GA|)	KA×GA
sin	U.U.U
sin2	NAM
sin3	EN.ZU
sinx(ŠID)	ŠID
sip	ME
sip2	PA.LU
sip3	AŠ@z&AŠ@z&AŠ@z&AŠ@z
sip4	PA.IB
sipa	PA.LU
sipa2	PA.IB
sipad	PA.LU
sipar	UD.KA.BAR
sippar	UD.GIŠ%GIŠ.NUN
siq	SIG
siqqax(PA)	PA
sir	SUD
sir2	BU
sir3	EZEN
sir4	ŠIR
sir5	NU
sirara	AB×HA
sirara2	UD.MA2.AB×HA.ŠIR
sirara3	UD.MA2.AB×HA.TAG
sirara4	UD.MA2.AB×HA
sirara5	AB@g
sirara6	UD.MA2.AB×HA.KI.TAG
siraran	AB×HA
sirarax(|AB×U+U+U|)	AB×U+U+U
siraš	ŠIM
siraš2	ŠIM×A
siraš3	ŠIM×GAR
sirda	EZEN
sirim2	EZEN
siris	ŠIM
siris2	ŠIM×A
siris3	ŠIM×GAR
siris4	BI
siris5	BI.MI
siriš	ŠIM
sirmuššu	IGI@g.TAK4.ALAN
sirru	NU11.IR
sirsir	BU&BU.AB
siru	ŠIR
sirum	ŠIR
sis	ŠEŠ
sisax(DI)	DI
sishe	GU%GU.GU%GU
sisi	ANŠE.KUR.RA
sisix(|ANŠE.KUR|)	ANŠE.KUR
siskur	AMAR×ŠE
siskur2	AMAR×ŠE.AMAR×ŠE
sissix(GI)	GI
sit2	ŠID
siu	UMUM×KASKAL
six(BU)	BU
six(SUD)	SUD
six(TAR)	TAR
six(|SI.A|)	SI.A
sizkur	AMAR×ŠE
sizkur2	AMAR×ŠE.AMAR×ŠE
siš	ŠEŠ
siškur	AMAR×ŠE
siškur2	AMAR×ŠE.AMAR×ŠE
su	SU
su10	MUŠ3@g
su11	KA
su12	SUM
su13	BU
su14	ZUM
su15	BI
su16	BUR2
su17	DUN
su18	DUN3
su2	ZU
su20	ŠIM
su3	SUD
su4	SI@g
su5	KU
su6	KA×SA
su7	LAGAR×ŠE
su8	DU&DU
su9	SI@g.A
sub	KA×GA
sub2	DU&DU
sub3	GU2×NUN
sub5	MUNSUB
sub6	TAG
sub7	RU
suba	ZA.MUŠ3@g
suba2	ZA.MUŠ3
suba3	MUŠ3.ZA
suba4?	MUŠ3
subar	ŠUBUR
subarrumx(ARAD)	ARAD
subir	ŠUBUR
subu	TAG
subur	ŠUBUR
subur2	LUH
suburx(ARAD)	ARAD
subx(KAL)	KAL
subx(|DAG.KISIM5×GA|)	DAG.KISIM5×GA
subx(|DU&DU.DU&DU|)	DU&DU.DU&DU
subx(|DU.DU.DU.DU|)	DU.DU.DU.DU
subx(|DU@s.DU@s|)	DU@s.DU@s
subx(|KA×UD|)	KA×UD
subx(|MUŠ3.ZA|)	MUŠ3.ZA
subx(|PAP.NA2|)	PAP.NA2
subx(ŠID)	ŠID
sud	SUD
sud2	SUD2
sud3	SU.KUR.RU
sud4	BU
sud5	EZEN×KASKAL
sudx(NU11)	NU11
sudx(|SU.KUR|)	SU.KUR
sudx(|SU.RU×KUR|)	SU.RU×KUR
suen	EN.ZU
suena	EN.ZU
sug	LAGAB×A
sug2	DU&DU
sug4	SUD
sug5	DUN3
sug6	SU
sug7	KA×LI
sug8	LAGAR×ŠE
sug9?	NUNUZ
sugal	ZA.MUŠ3@g.AB@g
sugal2	ZA.MUŠ3.AB@g
sugal3	MUŠ3.AB@g
sugal4	MUŠ3.ZA.AB@g
sugal5	MUŠ3.AB
sugal6	AB.MUŠ3
sugal7	LUH
sugin	BAD
sugix(|LAGAB×A|)	LAGAB×A
sugx(BU)	BU
sugx(KA)	KA
sugx(|DU&DU.DU&DU|)	DU&DU.DU&DU
sugx(|DU.DU.DU.DU|)	DU.DU.DU.DU
sugx(|DU@s.DU@s|)	DU@s.DU@s
sugx(|LAGAB×GAR|)	LAGAB×GAR
sugx(|PA.SUD.EL|)	PA.SUD.EL
sugx(|SUD.PA.EL|)	SUD.PA.EL
suh	MUŠ3@g
suh10	MUŠ3
suh2?	SUHUR
suh3	GU%GU
suh4	KID
suh5	KU
suh6	DU@g
suh7	MU
suhirim	LAGAR×ŠE+SUM
suhirin	LAGAR×ŠE+SUM
suhub	ŠU2.ANx3
suhub2	ANx3
suhub3	ŠU.DIŠ
suhub4	ŠU.DI.U.U.U
suhub5	ŠU.GA
suhul	ŠU2.ANx3
suhul2	IM.DUN3@g@g.DUN
suhul3	IM.DUN.DUN3@g@g
suhur	SUHUR
suhuš	DU@g
suhuš2	NINDA2×UŠ
suhušx(TUR)	TUR
suhušx(|UR×AL|)	UR×AL
suhušx(|ŠA6.TUR|)	ŠA6.TUR
suhx(TAG)	TAG
suk	LAGAB×A
suk3	URU×MIN
sukal	LUH
sukkal	LUH
sukkal2	SAL.HUB2
sukkal3	SAL.AL
sukkalgalx(|GAL.LUH|)	GAL.LUH
suku4	KI.URU×MIN
suku5	MUŠ3@g
suku6	MUŠ3
sukud	GALAM
sukud2	MUŠ3@g
sukud3	MUŠ3
sukux(GALAM)	GALAM
sukux(LIL)	LIL
sukuš	MUŠ3
sul	DUN
sul2	NI
sul3	KA×SA
sul4	LAGAR×ŠE
sulgar	ŠU2.ANx3
sullat	IDIM
sullat2	PA
sullim	EN×GAN2@t
sulu	TAR
sulug	LUL
suluhu	SIK2.SUD
suluhu2	SIK2.BU
suluhu3	ZI&ZI.LAGAB
suluhu4	LAGAB×A.LUM
suluhux(|A.ZI&ZI|)	A.ZI&ZI
suluhux(|ZI&ZI.A|)	ZI&ZI.A
suluhux(|ZI&ZI.EŠ2|)	ZI&ZI.EŠ2
sulumhi	SIK2.SUD
sulumhi2	SIK2.BU
sulumhi3	ZI&ZI.LAGAB
sulumhi4	LAGAB×A.LUM
sulummar	KI.SAG.DU
sulx(|KA×KID|)	KA×KID
sum	SUM
sum2	ZUM
sum3	SU
sum4	KA×SA
sum5	AŠ@k&AŠ@k&AŠ@k&AŠ@k
sum6	TAG
sumaš	SUMAŠ
sumu	SUM
sumug	UM
sumug2	UM×ŠA3
sumug3	UM×U
sumug4	UM×U.LAGAB
sumug5	UM×LAGAB
sumugan	GIR3
sumuganx(|ANŠE.PA|)	ANŠE.PA
sumugga	GIR3
sumugx(|UM.LAGAB|)	UM.LAGAB
sumugx(|URUDA×U.LAGAB|)	URUDA×U.LAGAB
sumugx(|URUDA×U|)	URUDA×U
sumukan	GIR3
sumun	TIL
sumun2	GUL
sumuna2	GUL
sumunda	LAGAR@g&LAGAR@g.ŠE
sumunu2	GUL
sumuqan	GIR3
sumur	SAG@g
sumur2	SUHUR
sumur3	MUNSUB
sumurx(KA)	KA
sumux(KA)	KA
sumx(|KA×KID|)	KA×KID
sumx(|ZI&ZI|)	ZI&ZI
sun	TIL
sun2	GUL
sun3	SUM
sun4	KA×SA
sun5	BUR2
sun6	ŠEN
sun7	KAL
suna	TIL
suna2	GUL
sunax(KAL)	KAL
sungin	BAD
sunx(|KA×KID|)	KA×KID
sup2	DU&DU
suq	LAGAB×A
sur	SUR
sur10	MA2.IGI@g
sur11	KU
sur12	LAGAR×ŠE
sur14	SAG
sur2	SAG@g
sur3	HI×AŠ
sur4	ŠA3×A
sur5	LAL
sur6	KI.GAL
sur7	KI.KAK
sur8	LAGAB×SUM
sur9	SUR9
sura	SUR
sura10	MA2.IGI@g
sura12	LAGAR×ŠE
sura13	EŠ2.KA
sura9	SUR9
surengal	A.LAGAB×HAL.UD.NUN.KI
surgal	A.LAGAB×HAL.UD.NUN.KI
suri	TUM
surra13	EŠ2.KA
surru	SUR9
surru2	MA2.IGI@g
suru5	LAL
suruen	EN.ŠEŠ
suruengal	UD.NUN
surugal	UD.NUN
surum?	NUN.LAGAR
surungal	UD.NUN
surx(AMAR)	AMAR
surx(BU)	BU
surx(ERIN2)	ERIN2
surx(LAGAB)	LAGAB
surx(NU)	NU
surx(UR)	UR
surx(UZ3)	UZ3
surx(|HI×AŠ2|)	HI×AŠ2
surx(|LAL.LAGAB|)	LAL.LAGAB
surx(|LAL2.TUG2|)	LAL2.TUG2
sus	MUŠ3@g
sus2	MUŠ3
susan	MUŠ3.EREN
susbu	MUŠ3@g.BU
susbu2	MUŠ3@g
susbu3	MUŠ3.BU
susbu4	MUŠ3
suslug	ŠU.LUL
susu	SUD2
susx(SUD2)	SUD2
sutu	BAR
sux(EREN)	EREN
sux(LAGAB)	LAGAB
sux(MI)	MI
sux(TAG)	TAG
sux(|DU&DU.DU&DU|)	DU&DU.DU&DU
sux(|DU.DU.DU.DU|)	DU.DU.DU.DU
sux(|DU@s.DU@s|)	DU@s.DU@s
sux(|KA×KID|)	KA×KID
suz	MUŠ3@g
suz2	MUŠ3
suzbu	MUŠ3@g.BU
suzbu2	MUŠ3@g
suzbu3	MUŠ3.BU
suš	KU
suš2	NI
suš3	BU
sušbu	MUŠ3@g
sušx(IŠ)	IŠ
ta	TA
ta*	TAx
ta2	DA
ta3	TAG
ta4	DAM
ta5	UD
ta6	TAK4
ta7	PI
ta8	HI
tab	TAB
tab2	GIR2@g
tab4	U.U
taba	TAB
tabira	DUB.NAGAR
tad	TAK4
tag	TAG
tag2	DAG
tag4	TAK4
taga	TAG
tagrimx(|LAGAB×KU3|)	LAGAB×KU3
tagrinx(|LAGAB×KU3|)	LAGAB×KU3
tah	MU&MU
tah2	GABA
tah3	MU
taha	MU&MU
tak	TAG
tak2	DAG
tak3	NI.UD
tak4	TAK4
taka	TAG
taka4	TAK4
taka\+	BALAG
tal	RI
tal2	PI
tal3	AŠ
tal4	DIŠ
tal5	KAD5.KAD5
tala	RI
tala2	PI
taltal	PI%PI
talx(HU)	HU
talx(LAK171@s)	LAK171@s
talx(|KAD5&KAD5.KAD5&KAD5|)	KAD5&KAD5.KAD5&KAD5
tam	UD
tam2	DAM
tam3	DIM
tam4	TUM
tam5	ERIN2
tam6	DIM2
tan	KAL
tan2	GA2×ME+EN
tan3	GA2×TAK4
tan4	GA2×GAN2@t
tan6	UŠ×TAK4
tan7	GA2×DA
tan8	UR
tana	KAL
tap	TAB
tapa	TAB
taq	TAG
taq2	DAG
taq3	NI.UD
tar	TAR
tar2	DAR
tar3	DARA3
tar5	GI
tara	TAR
tara3	DARA3
tarah	DARA3
tarahx(DARA4)	DARA4
targul	MA2.MUG
targulx(|MA2.KAK|)	MA2.KAK
tari	GUR
taru	GUR
taru5	GI
tas	UR
taskarin	TUG2
tat	TAK4
tatge	TAK4.TAK4
tax(TAR)	TAR
taz	UR
taş	UR
taš	UR
taš2	DIŠ
taš3	AŠ2
taša	UR
taškarin	TUG2
te	TE
te10	DI
te2	HI
te3	NAGA
te4	NE
te5	TUG2
te6	ŠID
te8	A2
te9	TI
tebiru	DUB.NAGAR
teg3	TE
tegi	BALAG.LUL
tegi2	LUL.BALAG
teh2	UM
tehe3	NIM
tehi	DUB
tehi2	UM
tehi3	NIM
tel	TIL
telmun	NI.TUK
teme	NAGA
teme2	NAGA@180
temen	TE
temennax(TE)	TE
temex(NAGA@t)	NAGA@t
temx(TE)	TE
ten	TE
ten2	DIN
ten3	DUN3@g@g
ter	ŠE.NUN&NUN
ter4	SI.A
tertu	PA.SU
terx(|GIŠ×TAK4|)	GIŠ×TAK4
terx(|KA×PI|)	KA×PI
tex(TE@g)	TE@g
teĝ3	TE
teĝ4	TI
teš	AŠ
teš2	UR
tešbi	U2
tešlug	LU2×LAGAB
tešub	IM
ti	TI
ti2	HI
ti3	DIM
ti4	DI
ti5	BAD
ti7	TE
ti8	A2
ti9	NE
tib	DIB
tibir	TAG
tibir2	TAG×ŠU
tibir3	TAG×UD
tibir4	TAG×TUG2
tibir5	TAG×GUD
tibira	DUB.NAGAR
tibira2	KA×GIŠ%GIŠ
tibirx(|TAG×ŠE|)	TAG×ŠE
tibnu	TI@t
tibula	ŠA3.MIN.TAR
tibula2?	ŠA3.MIN.KASKAL
tibula3?	ŠA3.MIN.DI
tibx(KU)	KU
tid?	IM
tidanu	PIRIG.PIRIG
tidanum	PIRIG.PIRIG
tidnim	PIRIG.PIRIG
tidnu	PIRIG.PIRIG
tidnum	PIRIG@PIRIG
tidnumx(|ERIN2.X1|)	ERIN2.X1
tig3	DUB2
tig4	TI
tigi	BALAG.LUL
tigi2	LUL.BALAG
tigidla	ŠA3.TAR
tigidla2	ŠA3.MIN.KASKAL
tigidla3	ŠA3.MIN.DI
tigidlax(|ŠA3.MIN.TAR|)	ŠA3.MIN.TAR
tigix(|KID.BALAG|)	KID.BALAG
tigu	BALAG.LUL
tigu2	LUL.BALAG
tik	GU2
til	TIL
til2	LAGAR@g
til3	TI
til4	AŠ
til5	DIŠ
til6	KAD5.KAD5
til7	PI
til8	KUL
til9?	MAŠ
tila	URI
tila3	TI
tile	BAD
tilhar	GA2×BAD
tilla	URI
tilla2	AN.AŠ.AN
tilla3?	AN.DIŠ.AN
tilla4?	AN.AŠ.A.AN
tilla5	AN.AŠ@z.AN
tillax(|AN&AN|)	AN&AN
tilmun	NI.TUK
tilx(DIN)	DIN
tilx(LAK171@s)	LAK171@s
tilx(|KAD5&KAD5.KAD5&KAD5|)	KAD5&KAD5.KAD5&KAD5
tilx(|TUR.TUR|)	TUR.TUR
tilx?(KUL@g)	KUL@g
tim	DIM
tim2	TUM
tim3	DIN
timuax(NA2)	NA2
tin	DIN
tin3	DUN3@g@g
tinur	LAGAB×IM
tinur2	ŠU.LAGAB.NA
tinur3	LAGAB×GAR
tinuru	LAGAB×IM
tinurx(|ŠU.LAGAB|)	ŠU.LAGAB
tip	DIB
tiq	GU2
tiq2	NI
tir	ŠE.NUN&NUN
tir2	TAR
tir3	DAR
tir4	SI.A
tir5	PAN
tirigi?	SAG.AN
tiru	GAL.TE
tirum	GAL.TE
tirx(|GIŠ×TAK4|)	GIŠ×TAK4
tirx(|NUN&NUN|)	NUN&NUN
tis2	UR
titab	BARA2.PAP.ŠE.PAP
titab2	LU3.PAP.PAP
titabx(|EŠ2.LU3|)	EŠ2.LU3
tiz	DIŠ
tiz2	UR
tiĝ4	TI
tiş2	UR
tiš	DIŠ
tiš2	UR
tiškarin	TUG2
tiškarini	TUG2
tišpak	MUŠ3@g
tu	TU
tu10	HUB2×UD
tu11	HUB2
tu12	TUK
tu13	LAGAB×U+U+U
tu14	ŠID
tu15	IM
tu16?	DUB2
tu17	A.ŠU.NAGA
tu18	DUN3
tu19?	TUR
tu2	UD
tu20	KAK
tu21	LAGAR@g
tu22	NAGA
tu23	NAGA×ŠU@t
tu24	GABA
tu25	NIM×GAN2@t
tu3	DU
tu4	TUM
tu5	ŠU.NAGA
tu6	KA×LI
tu7	HI×BAD
tu8	NIM
tu9	TUG2
tub	DUB
tub2	DUB2
tuba	ME
tuba2	A.HA
tuba3	ŠID
tubax(TUG2)	TUG2
tubašin	KU7
tud	TU
tud2	PA.UZU
tudu	PA.UZU
tug	TUK
tug2	TUG2
tug3	DUG
tug4	LAGAB×U+U+U
tug7	IM×TAK4
tug8	DUN3
tugir	TUG2.DU@s
tugul	NAGAR.ZA@t
tugure	KA×GAN2@t
tugx(LAK483)	LAK483
tuh	GABA
tuh2	MU&MU
tuh3	MU
tuhu	GABA
tuhul	NAGAR.ZA@t
tuk	TUK
tuk2	TUG2
tuk3	DUG
tuk4	LAGAB×U+U+U
tuk7	IM×TAK4
tuku	TUK
tuku2	TUG2
tuku4	LAGAB×U+U+U
tuku5	TAG
tuku6	LAGAB
tukul	KU
tukul2	GIŠ.KU
tukula	KU
tukulx(LAGAB)	LAGAB
tukum	ŠU.GAR.TUR.LAL
tukumbi	ŠU.GAR.TUR.LAL.BI
tukumbix(|ŠU.LAL.TUR|)	ŠU.LAL.TUR
tukumx(|ŠU.GAR|)	ŠU.GAR
tukumx(|ŠU.TUR|)	ŠU.TUR
tukun	ŠU.GAR.TUR.LAL
tukunbi	ŠU.GAR.TUR.LAL.BI
tukur	LAGAB
tukur2	KA×ŠE
tukur3	KA×U2
tukurex(|KA×ŠE|)	KA×ŠE
tukurx(|LAGAB×U|)	LAGAB×U
tukx(HUB2)	HUB2
tukx(TAK4)	TAK4
tukx(|IM.KAD3|)	IM.KAD3
tul	U.TUG2
tul2	LAGAB×U
tul4	TUR
tul5	LAGAR@g
tul6	DUN4
tul7	UR@s
tul8	LAGAB×BAD
tum	TUM
tum10	DAM
tum11	NIM×GAR+GAN2@t
tum12	TU
tum13	EGIR
tum2	DU
tum3	NIM×GAN2@t
tum4	NIM
tum5?	KU
tum8	DIM
tum9	IM
tuma2	DU
tuma?	KU
tumu	IM
tumu2	DU
tumu3	NIM×GAN2@t
tumu4	NIM
tumx(HUB2)	HUB2
tumx(|HUB2×UD|)	HUB2×UD
tun3	DUN3
tun4	DUN
tuna3	DUN3
tunda	PA.UZU
tungal	EN.ZU
tungal2	EN.KI
tunur	LAGAB×IM
tunx(DUB2)	DUB2
tunx(|KA×SA|)	KA×SA
tunĝal2	EN.KI
tup	DUB
tup2	DUB2
tuq	TUK
tuq3	DUG
tur	TUR
tur-tur	TUR.TUR
tur2	GU2×KAK
tur3	NUN.LAGAR
tur4	GIŠ%GIŠ
tur5	TU
tur6	LAGAB
tur7	DUR2
tur8?	BU
tura	TUR
turan?	GU2×KAK.GIŠ%GIŠ
turu	TUR
turungal	UD.NUN
tutke	LAGAB×U+U+U.LAGAB×U+U+U
tutki	LAGAB×U+U+U.LAGAB×U+U+U
tutku	LAGAB×U+U+U.LAGAB×U+U+U
tux(|KA×IM|)	KA×IM
tux(|KA×UD|)	KA×UD
tux(|ŠE.NAGA|)	ŠE.NAGA
tuš	KU
tuše	A.DU
tušu	KU
tuššuru	A.DU
u	U
u'	ALEPH
u'2?	HI×NUN
u'3	LAGAB×GUD
u'4	UD.KUŠU2
u'a	LAGAB×(GUD+GUD).A
u'i	LAGAB×(GUD+GUD).A
u'u	LAGAB×(GUD+GUD).A
u-gun3	U.DAR
u-gunx(|DIŠ.DAR|)	DIŠ.DAR
u10	DARA4
u11	HU
u12	UN
u13	HI×NUN
u14?	U.GA
u16	UM
u17	PI
u18	URU×MIN
u19	URU
u2	U2
u20	ŠE
u21	PIRIG×UD
u22	UD×U+U+U
u3	IGI.DIB
u4	UD
u4-sakar	UD.SAR
u5	HU.SI
u6	IGI.E2
u7	KI.MIN
u8	LAGAB×GUD+GUD
u9	EZEN×BAD
ua	LAGAB×GUD+GUD
ua2	DARA4
ua4	DAG.KISIM5×LU+MAŠ2
ub	UB
ub2	EŠ2
ub3	AB2×ŠA3
ub4	LAGAB×U
ub5	AB2×TAK4
ub6	AB2×ME+EN
uba	UB
uba2	EŠ2
uba5	AB2×TAK4
ubar	EZEN×KASKAL
ubara	EZEN×KASKAL
ubda	UB
ubdax(KI)	KI
ubi	GALAM
ubi2	SUHUR
ubilla	GIŠ.NE@s
ubilla2	GIŠ.MI
ubinigga	TAB&TAB.NI&NI.DIŠ&DIŠ
ubisag	ŠID
ubisag2	ŠID×A
ubišaga?	TAB&TAB.NI&NI.DIŠ&DIŠ
ubri	IGI.KAK
ubri2	IGI.DIM
ubrim	IGI.KAK
ubu	AŠ@z
ubu2	UB
ubudil	NINDA2×U2+AŠ
ubudili	NINDA2×U2+AŠ
ubur	DAG.KISIM5×GA
ubur2	DAG.KISIM5×LU
ubur3	DAG.KISIM5×IR
ubur4	DAG.KISIM5×IR+LU
ubura	AŠ@k
uburu	AŠ@k
ubx(|AB2.ŠA3|)	AB2.ŠA3
ubx(|EZEN×BAD|)	EZEN×BAD
ubx(|URU×GAN2@t|)	URU×GAN2@t
ud	UD
ud2	AŠ2
ud2-duru5	AŠ2.A
ud3	HU.SI
ud4	TAG×KU
ud5	UZ3
ud6	U.GA
uda5	UZ3
udax(ERIN2)	ERIN2
udda	LAGAB×KIN
udeššu	AŠ2
udinim	EZEN×IGI@g
udkinx?(|SIK2.LAM|)	SIK2.LAM
udnim	EZEN×IGI@g
udnimx(|EZEN×HA|)	EZEN×HA
udnimx(|EZEN×KU3|)	EZEN×KU3
udra	AŠ2.A.AN
udra2	AŠ2.AN.NA
udra3	AŠ2.AN
udrax(|AŠ2.A|)	AŠ2.A
udru	AŠ2.A.AN
udu	LU
udu2	ŠU.BAD
udub	LAGAB×NE
udub2	ŠITA2
udub3	NE.SI.A
udug	UDUG
udug2	ŠITA2
udul	AB2.KU
udul10	AB2.LU
udul11	PA.DAG.KISIM5×GUD
udul2?	HI×BAD
udul3	DAG.KISIM5×LU+MAŠ2
udul4	PA.DAG.KISIM5×LU+MAŠ2
udul5	DAG.KISIM5×GUD
udul6	DAG.KISIM5×UŠ
udul7	KAM2
udul8	U.MU
udul9	PA.DAG.KISIM5×KAK
udulx(|PA.NUN.LAGAR|)	PA.NUN.LAGAR
udun	U.MU
udux(UDUG)	UDUG
udx(|PIRIG×UD|)	PIRIG×UD
ug	PIRIG×UD
ug2	PIRIG
ug3	UN
ug4	UD
ug5	EZEN×BAD
ug6	IGI.E2
ug7	UŠ2
ug8?	LU2@s
uga	U2.NAGA.GA
uga2	A.KA
uga3	UN
uga5	EZEN×BAD
ugab	SUHUR
ugal	KA×UŠ
ugar	A.GAR3
ugax(NAGA)	NAGA
ugax(U2)	U2
ugax(|NU11.BUR|)	NU11.BUR
ugax(|U2.NAGA|)	U2.NAGA
ugnim	KI.SU.LU.EŠ2.GAR
ugnimx(|KI.LU.EŠ2|)	KI.LU.EŠ2
ugnimx(|KI.SU.LU.EŠ2.GAR.RA|)	KI.SU.LU.EŠ2.GAR.RA
ugnimx(|KI.SU.LU.GAR|)	KI.SU.LU.GAR
ugnimx(|KI.SU.LU.KI.GAR|)	KI.SU.LU.KI.GAR
ugnimx(|KI.SU.LU.LAGAB×U.GAR|)	KI.SU.LU.LAGAB×U.GAR
ugnimx(|KI.SU.LU.ŠU.GAR|)	KI.SU.LU.ŠU.GAR
ugnimx(|KI.SU.ZA.LU.EŠ2|)	KI.SU.ZA.LU.EŠ2
ugnimx(|LU.EŠ2.GAR.KI|)	LU.EŠ2.GAR.KI
ugnimx(|SU.KI.LU.EŠ2.KI|)	SU.KI.LU.EŠ2.KI
ugra	LAGAB×U2+AŠ
ugri	LAGAB×U2+AŠ
ugu	U.KA
ugu2	A.KA
ugu3	A.SAG
ugu4	KU
ugu5	SAG@g
ugudil	NINDA2×U2+AŠ
ugudili	NINDA2×U2+AŠ
ugula	PA
ugulu	PA
ugun	U.DAR
ugun2	GAŠAN
ugun3	U.KA
ugunu	U.DAR
ugunu2	GAŠAN
ugur	U.GUR
ugur2	IGI@g
ugurx(|GU2×KAK×IGI@g|)	GU2×KAK×IGI@g
ugux(SAG@n@g)	SAG@n@g
ugux(|A.U.KA|)	A.U.KA
ugux(|U.SAG|)	U.SAG
ugx(|NINDA2×NE|)	NINDA2×NE
ugx(|PIRIG×ZA|)	PIRIG×ZA
uh	HI×NUN
uh2	UD.KUŠU2
uh3	KUŠU2
uh4	KA×BAD
uh5	ALEPH
uh6	IM.ŠU2
uhhur2?	IGI.GA
uhhur3	IGI.A
uhhur?	IGI.BI
uhu	HI×NUN
uhu2	UD.KUŠU2
uia	U.5(DIŠ)
uk	PIRIG×UD
uk5	EZEN×BAD
ukdin	IGI@g.ALAN
ukken	URU×BAR
ukkin	URU×BAR
ukra	GAL.ŠUBUR
uktin	IGI@g.ALAN
uku	DUN3@g@g
uku-uš	DUN3@g.UŠ
uku2	LAL2.DU
uku3	UN
uku4	PIRIG×UD
uku5	LAL2.DU.DU
ukum	IŠ
ukur2	GAL.ŠUBUR
ukur3	LAL2.DU
ukur4	LAL2.DU.DU
ukur5	IGI@g
ukur?	GIR2
ukurrim	EN.ME.AN.MUŠ3
ukuš	DUN3@g@g.UŠ
ukuš2	HUL2
ul	U.GUD
ul12	URU×MIN
ul2	NU
ul3	GIŠ%GIŠ
ul4	GIR2@g
ul5	EZEN×KASKAL
ul6	UD
ul7	ŠU.BU
ul8?	GAN2
ula	U.GUD
ula2	GA2×U
ulal	BAD
ulax(|E2×U|)	E2×U
uli	KA×ME
ulil	AŠ@k
ullu	U.GUD
ullu3	U.GUD
ulu	U.GUD
ulu2	HI×NUN.ME.U
ulu3	URU×MIN
ulu4	URU
ulubar	IM.GAN2.HI×NUN.ME.U
ulubar2	IM.HI×NUN.ME.U.GAN2
ulud	DUG
uludi?	MUŠ
uludim	KI.KAL
uludim2	IGI@g.ALAN
uludin	KI.KAL
uludin2	IGI@g.ALAN
uluki?	MUŠ
ulul	GIŠ%GIŠ
ulul2	GAN2%GAN2
ululx(GAN2)	GAN2
ulumaš	IM.GAN2.HI×NUN.ME.U
ulumaš2	IM.HI×NUN.ME.U.GAN2
ulutim	KI.KAL
ulutim2	IGI@g.ALAN
ulutin	KI.KAL
ulutin2	IGI@g.ALAN
ulušin	BI.AŠ2.A.AN
ulušin2	BI.AŠ2.AN.NA
ulušin3	BI.AŠ2.AN
ulušinx(|BI.A.SUD|)	BI.A.SUD
ulušinx(|BI.AŠ2|)	BI.AŠ2
ulx(|U.GA|)	U.GA
um	UM
um-me-da	UM.ME
um2	UD
uma	AŠ@k
umah	LAGAB×U+A
umahx?(|SAL.LAGAR|)	SAL.LAGAR
uman	HI×NUN
umbara	EZEN×KASKAL
umbin	UMBIN
umbisag	ŠID
umbisag2	ŠID×A
umbisaĝ	ŠID
umbisaĝ2	ŠID×A
umma	GIŠ.KUŠU2
umma2?	HI×DIŠ
umman	KI.SU.LU.EŠ2.GAR
ummanu	KI.SU.LU.EŠ2.GAR
ummax(|GIŠ.SAL.KUR|)	GIŠ.SAL.KUR
ummax(|KA.HI.GA|)	KA.HI.GA
ummax(|UB.ME|)	UB.ME
ummeda	UM.ME
ummeda2	UM×ME+DA
ummenx(|GIŠ.KUŠU2|)	GIŠ.KUŠU2
ummix(|GIŠ.KUŠU2|)	GIŠ.KUŠU2
ummu	A.EDIN.A.LAL
ummu3	A.EDIN.LAL
ummud?	A.EDIN.LAL
ummudx(|A.EDIN|)	A.EDIN
ummudx(|A.U.EDIN.LAL|)	A.U.EDIN.LAL
ummux(|A.EDIN|)	A.EDIN
ummux(|A.U.EDIN.LAL|)	A.U.EDIN.LAL
ummux(|EDIN.A.LAL|)	EDIN.A.LAL
ummux(|EDIN.A|)	EDIN.A
ummux(|EDIN.LAL.A|)	EDIN.LAL.A
umu	UM
umuh	LAGAB×U+A
umum	UMUM
umun	U
umun10?	U.MU
umun11	LAGAB×A
umun12?	LAGAB×UD
umun2	UMUM
umun3	HI×NUN
umun4	ALEPH
umun5	LAGAB×U+A
umun6	LAGAB×HI×NUN
umun7	IMIN
umun8	TAB.TAB.TAB.AŠ
umun9	AŠ&AŠ&AŠ.AŠ&AŠ&AŠ.AŠ
umunax(IMIN)	IMIN
umunx(|LAGAB×GAR|)	LAGAB×GAR
umuš	TUG2
umx(UN)	UN
un	UN
un2	U
un3	EZEN×BAD
un4	EZEN×KASKAL
un5	UD
unken	URU×BAR
unkin	URU×BAR
unkinx(|KA×BAR|)	KA×BAR
unu	AB@g
unu10	GI%GI
unu11	ZA.MUŠ3@g.AB@g
unu12	BU%BU
unu2	TE.AB@g
unu3	AB2.KU
unu4	UN
unu5	AB
unu6	TE.AB
unu7	TE@g.AB@g
unu8	UŠ
unu9	KAD4
unud	AB2.KU
unug	AB@g
unug2	TE.AB@g
unug3	TE.AB
unug4	TE@g.AB@g
unugi	AB×IGI@g
unugi2	AB×GAL
unugx(|AB×U+U+U|)	AB×U+U+U
unux(LAK171@s)	LAK171@s
unux(TE)	TE
unux(|AB×U+U+U|)	AB×U+U+U
unux(|HI×AŠ2|)	HI×AŠ2
unux(|TE.MUŠ3|)	TE.MUŠ3
unx(|EZEN×X|)	EZEN×X
up	UB
up2	EŠ2
upux(AŠ@z)	AŠ@z
uq	PIRIG×UD
uq5?	EZEN×BAD
ur	UR
ur-ur	UR%UR
ur10	URI
ur11	APIN
ur12	TE@g
ur13?	RAB.GAL
ur14	GA2×SAL
ur2	UR2
ur3	GA2×NUN&NUN
ur4	UR4
ur5	HI×AŠ2
ur5-gu7	HI×AŠ2.KA×GAR
ur5-ša4	HI×AŠ2.DU
ur6?	U.GUD
ur7	NINDA2×U2+AŠ
ur9	UR2×U2+AŠ
ura	UR
ura15	ŠEŠ.AB@g
ura16	ŠEŠ.AB
ura3	GA2×NUN&NUN
ura4	UR4
ura5	HI×AŠ2
uram	ŠEŠ.AB@g
uram2	ŠEŠ.AB
uraš	IB
urbigu	UR%UR
urbigu2	EN%EN
urbigu3	LU2@LU2
urbingu	UR%UR
urbingu2	EN%EN
urbingu3	LU2@LU2
urda	ARAD
urda2	ARAD×KUR
urdu	ARAD
urdu2	ARAD×KUR
urgilim	NUN%NUN
urgu	HI×AŠ2.KA×GAR
urgu2	KA×NE
uri	URI
uri2	ŠEŠ.AB@g
uri3	URI3
uri4	IDIM
uri5	ŠEŠ.AB
urim2	ŠEŠ.AB@g
urim5	ŠEŠ.AB
urimx(URI3)	URI3
urin	URI3
urinx(|ŠEŠ.HU.HU|)	ŠEŠ.HU.HU
urrub	DUG
urrub2	KAL
ursagsim	TAR
ursaĝsim	TAR
ursub	DUG
ursub2	KAL
urta	IB
uru	URU
uru10	SAG×DUB
uru11	URU×GAN2@t
uru12	GA2×NUN&NUN
uru13	UR
uru14	ŠEŠ.AB@g
uru15	ŠEŠ.AB
uru16	EN
uru17	URU×MIN
uru18	URU×A
uru19	URI
uru2	URU×UD
uru3	URI3
uru4	APIN
uru5	TE@g
uru6	NINDA2×U2+AŠ
uru7	UR2×U2+AŠ
uru8	UR2
uru9	SIG4.IDIM
urua	URU×A
uruaka	GAD.TAK4.GIŠ
urub	URU×GAN2@t
urud	URUDA
urud2	DUB
uruda	URUDA
urudu	URUDA
urudu2	DUB
urugal	AB×GAL
urugal2	AB@g
urugalx(|AB×U+U+U|)	AB×U+U+U
urugalx(|URU×GAL|)	URU×GAL
uruišdua	GAD.TAK4.GIŠ
uruišduha	GAD.TAK4.GIŠ
uruk	AB@g
urukx(|AB×U+U+U|)	AB×U+U+U
urulla	GAD.TAK4.GIŠ
urum	NINDA2×U2+AŠ
urum2	UR2×U2+AŠ
urum3	SAG×DUB
urum4	UR2×HA
urum5	ŠEŠ.AB@g
urum6	ŠEŠ.AB
urum7	U.ŠA
urum8	UR2×U2
urum9	UR2×A+HA
urume	ERIN2.NA
urumx(IDIM)	IDIM
urumx(|URU×UD|)	URU×UD
urumx?(|SIG4.IDIM|)	SIG4.IDIM
urun	URI3
urunx(EN)	EN
ururim	URU×UD
urutamga	URU×GAN2@t
urutamga2	URU×UD
urux(|EZEN×X|)	EZEN×X
urux(|HI×AŠ2|)	HI×AŠ2
urux(|UR2×HA|)	UR2×HA
uruĝal2	AB@g
urušeb	URU×HA
urušib	URU×HA
urušibx?(|URU×UD|)	URU×UD
urx(TAK4)	TAK4
urx(|E2×SAL|)	E2×SAL
urx(|HI×ŠE|)	HI×ŠE
urzub	DUG
urşub	DUG
urša	HI×AŠ2.DU
us	ŠE.HU
us2	UŠ
us3?	UZ3
us4	PIRIG×ZA
us5	LAGAB×GUD+GUD
usa2	UŠ
usab	UD.NUN
usag	SAG×U2
usagx(|NUNUZ.AB2×GUD|)	NUNUZ.AB2×GUD
usagx(|NUNUZ.AB2×LA|)	NUNUZ.AB2×LA
usagx(|U.ŠA|)	U.ŠA
usan	GU2×NUN
usan2	GU2@g
usan3	NUNUZ.AB2×AŠGAB
usan3-sur5	NUNUZ.AB2×AŠGAB
usan4	SI@g
usan5	HU
usanda	HU.KAK
usandu	HU.KAK
usandux(|NUNUZ.AB2×AŠGAB|)	NUNUZ.AB2×AŠGAB
usansurux(|NUNUZ.AB2×AŠGAB|)	NUNUZ.AB2×AŠGAB
usanx(AN)	AN
usanx(GU2)	GU2
usanx(KAK)	KAK
usanx(|AN.GU2×KAK|)	AN.GU2×KAK
usanx(|AN.GU2×NUN|)	AN.GU2×NUN
usanx(|GU2×KAK|)	GU2×KAK
usanx(|NUNUZ.AB2×GUD|)	NUNUZ.AB2×GUD
usar	LAL2.SAR
usar2	LAL.SAR
usar3	LAL2.LAGAB
usar4	LAL.LAGAB
usax(GU2@g)	GU2@g
usduha	LAGAB×GUD.LU.HI.A
usi	GA2×ŠE
usian	GU2×NUN
usigi?	EZEN×KASKAL
usil	EZEN×U2
usix(|E2×ŠE|)	E2×ŠE
ussa2	TAB.TAB.TAB.TAB
ussa3	AŠ&AŠ&AŠ.AŠ&AŠ&AŠ.TAB
ussu	USSU
ussu2	TAB.TAB.TAB.TAB
ussu3	USSU3
usu	A2.KAL
usu2	UŠ
usud	GA2×AN.KAK.A
usug	ZAG.AN
usug2	U2.KA
usug3	SAG×U2
usug4	U2.KUR.NI.TUK.KI
usug5	KA×U2
usuh?	SAL.LAGAR
usun	NUNUZ.AB2×AŠGAB
usur	LAL2.SAR
usur4	LAL.LAGAB
usux(UZU)	UZU
usx(|SIK2.AŠ|)	SIK2.AŠ
ut	UD
ut2	AŠ2
ut4	TAG×KU
ut5	UZ3
ut6	U.GA
uta	UD
utag	AŠ@k
utah	U.GA
utahx(U)	U
utak	AŠ@k
utima	GA2×MI
utima2	UD×MI
utte	KI.KI
uttu	TAG×TUG2
uttu2	ŠID
uttu4	MUG@g
uttu5	UŠ.BAR
uttu6	KI.LAL
uttuku	GAR.ŠID
uttux(TAG)	TAG
uttux(|TAG×KU|)	TAG×KU
utu	UD
utu2	U.GA
utu3	U.U
utu4	KI.KI
utu5	AŠ2
utua	DAG.KISIM5×UŠ
utua2	DAG.KISIM5×LU+MAŠ2
utudi?	UTUKI
utug	UDUG
utug2?	ŠITA2
utugx(|GAR.ŠID|)	GAR.ŠID
utuki?	UTUKI
utul	AB2.KU
utul10	AB2.LU
utul11	PA.DAG.KISIM5×GUD
utul2	HI×BAD
utul3	DAG.KISIM5×LU+MAŠ2
utul4	PA.DAG.KISIM5×LU+MAŠ2
utul5	DAG.KISIM5×GUD
utul6	DAG.KISIM5×UŠ
utul7	KAM2
utul8	U.MU
utul9	PA.DAG.KISIM5×KAK
utulx(|HI×DIŠ|)	HI×DIŠ
utun	U.MU
utuqx(|GAR.ŠID|)	GAR.ŠID
utuwa	DAG.KISIM5×UŠ
utuwa2	DAG.KISIM5×LU+MAŠ2
utux(U)	U
utux(|TAG×TUG2|)	TAG×TUG2
uw	PI
ux(NI)	NI
ux(PA)	PA
ux(|EZEN×AN|)	EZEN×AN
ux(|SIK2.AŠ|)	SIK2.AŠ
uya	U.5(DIŠ)
uz	ŠE.HU
uz2	UŠ
uz3	UZ3
uz4	PIRIG×ZA
uz5	LAGAB×GUD+GUD
uza	ŠE.HU
uza3	UZ3
uzaglal	AŠ@z
uzalag	AŠ@k
uzalak	AŠ@k
uzduha	LAGAB×GUD.LU.HI.A
uzu	UZU
uzu2	ZU5×A
uzu3	ŠE.HU
uzu5	U.UD
uzud	UZ3
uzug	ZAG.AN
uzug2	U2.KA
uzug3	U2.SAG
uzug4	U2.KUR.NI.TUK.KI
uzug5	KA×U2
uzugx(KA)	KA
uzugx(|AN.ZAG|)	AN.ZAG
uzunx(|NUNUZ.AB2×AŠGAB|)	NUNUZ.AB2×AŠGAB
uĝ2	PIRIG
uĝ3	UN
uĝ5	EZEN×BAD
uś	UŠ
uş	ŠE.HU
uş2	UŠ
uş4	PIRIG×ZA
uš	UŠ
uš10	ŠE.HU
uš11	KA×BAD
uš14	KA×PI
uš15	SI.A
uš16?	ŠU.BAD
uš17	HI×AŠ
uš18	U.U.U
uš2	UŠ2
uš3	GA2×SAL
uš4	TUG2
uš5	NUN.LAGAR×SAL
uš6	NUN.LAGAR×MAŠ
uš7	KA×LI
uš8	APIN
uš9	DIŠ
ušar	LAL2.SAR
ušar2	LAL.SAR
ušar3	LAL2.LAGAB
ušar4	LAL.LAGAB
ušbar	UR2×NUN
ušbar2	ZU5×A
ušbar3	UR2×U2+AŠ
ušbar4?	SUMAŠ
ušbar5?	U.EN×GAN2@t
ušbar6	NINDA2×U2+AŠ
ušbar7	UR2×U2
ušbarx(|SUMAŠ.MAŠ|)	SUMAŠ.MAŠ
ušbur	UR2×NUN
ušbur2	ZU5×A
ušbur3	UR2×U2+AŠ
ušbur4	SUMAŠ
ušbur5	U.EN×GAN2@t
ušbur6	NINDA2×U2+AŠ
ušbur7	UR2×U2
ušen	GU2×NUN
ušera	LAGAB×U2+AŠ
ušeri	LAGAB×U2+AŠ
uštu	PI
uštu2	UŠ.TUG2.PI
uštug	PI
uštug2	UŠ.TUG2.PI
uštuh	KI.IB
ušu	BUR2
ušu2	U.UD
ušu3	U.U.U
ušub	SI.A
ušum	BUR2
ušumgal	GAL.BUR2
ušumgalx(|KWU089.GAL|)	KWU089.GAL
ušumx(KWU089)	KWU089
ušur	LAL2.SAR
ušur2	LAL.SAR
ušur3	LAL2.LAGAB
ušur4	LAL.LAGAB
ušur5	U
ušurx(|LAL2.TUG2|)	LAL2.TUG2
ušuš	GA2×NUN
ušx(UŠX)	UŠX
ušx(|E2×SAL|)	E2×SAL
ušx(|KA×ŠU|)	KA×ŠU
ušša	HI×AŠ
uššux(|A2.KAL|)	A2.KAL
uţ	UD
uţe	KI.KI
uţu	TAG×TUG2
uţu2	ŠID
uţu4	MUG@g
uţu5	UŠ.BAR
uţu6	KI.LAL
uţuku	GAR.ŠID
v+	GIŠ.NI
wa	PI
wa2	BA
wa3	U2
wa4	PI×A
wa6	MA
wan	U.U
war2	MAR
war3	ARAD
war?	BAR
wardu	ARAD
warx(UB)	UB
wax(|LAGAB×GUD+GUD|)	LAGAB×GUD+GUD
wax(|LAGAB×GUD|)	LAGAB×GUD
wax(|SIK2.AŠ|)	SIK2.AŠ
waš	MAŠ
we	PI
we2	PI×E
wi	PI
wi2	PI×I
wi4	MI
wi5	GIŠ.DIN
wir	GIR3
wiš?	ME.U.U.U
wu	PI
wu2	PI×U
wu3	PI×U2
wu4	MU
wuk	MUG
wux(U2)	U2
wuš	MUŠ
x	x
xx(|SAG×KAK.GABA|)	SAG×KAK.GABA
ya	PI
ya10	A
ya3	NI
ya4	NI.UD
yax(|A.A|)	A.A
yax(|UD.NI|)	UD.NI
ye	PI
yi	PI
yi2	I.A
yi3	E
yu	PI
za	ZA
za2	NI.UD
za3	ZAG
za4	NUN
za5	AN
za6	KA×UD
za7	ZA7
zab	ERIN2
zabala	ZA.MUŠ3@g.AB@g
zabala2	ZA.MUŠ3.AB@g
zabala3	MUŠ3.AB@g
zabala4	MUŠ3.ZA.AB@g
zabala5	MUŠ3.AB
zabala6	AB.MUŠ3
zabalam	ZA.MUŠ3@g.AB@g
zabalam2	ZA.MUŠ3.AB@g
zabalam3	MUŠ3.AB@g
zabalam4	MUŠ3.ZA.AB@g
zabalam5	MUŠ3.AB
zabalam6	AB.MUŠ3
zabalax(|AB@g.MUŠ3.ZA|)	AB@g.MUŠ3.ZA
zabalax(|AN.MUŠ3.AB@g|)	AN.MUŠ3.AB@g
zabalax(|AN.MUŠ3.AB|)	AN.MUŠ3.AB
zabalax(|MUŠ3.AB@g.ZA|)	MUŠ3.AB@g.ZA
zabar	UD.KA.BAR
zabar2	ZUBUR
zabar3	KA×UD.BAR
zabitum	BALAG.TUR
zadim	MUG@g
zadri	ŠID
zadru	ŠID
zag	ZAG
zag2	PA
zag3	NISAG
zagga	NI
zagga2	ZA
zagindur	ZA.KUR.A
zagx(|U.GA|)	U.GA
zah	NE
zah2	HA.A
zah3	A×HA
zaha2	HA.A
zaha3	A×HA
zahan	U.GA.HI
zahan2	U.GA
zahx(|A.HA.A|)	A.HA.A
zahx(|A.HA|)	A.HA
zahx(ŠEŠ)	ŠEŠ
zak	ZAG
zak2	PA
zal	NI
zal2	LAGAB×SUM
zala	NI
zalag	UD
zalag2	ERIN2
zalaga	UD
zalah	UD
zalaqax(UD)	UD
zalax(UD)	UD
zalli	NI
zalx?(NUN)	NUN
zamin	UB.RI
zamx(ZAMX)	ZAMX
zanabal	LU2×LA+AŠ
zanabal2	LU2×KAD3+AŠ
zanabal3	LU2×SI+AŠ
zanaru	MUŠ3
zanaru2	ZA.MUŠ3
zanbur	BAD.KASKAL
zandar	ŠID
zandara	ŠID
zannaru	ZA.MUŠ3@g
zannaru2	ZA.MUŠ3
zannarux(|ZA.AN.MUŠ3@g|)	ZA.AN.MUŠ3@g
zansur	LAGAB×U+U+U
zanzana	HI×ŠE
zap	ERIN2
zap2?	KU
zapah	ŠU.BAD
zaq	ZAG
zaq2	PA
zaq4	ZIG
zar	LAGAB×SUM
zar2	NI
zar3	SUM
zar4	KUL
zar5	BAD
zar6	BAD.AŠ
zara	LAGAB×SUM
zara5	BAD
zara6	BAD.AŠ
zarah	SAG.PA.LAGAB
zarah2	LU.KI.KAK
zarahx(|KI.KU.SAG|)	KI.KU.SAG
zarahx(|KI.SAG.SAL|)	KI.SAG.SAL
zarahx(|KU.KI.SAG|)	KU.KI.SAG
zarax(KUL)	KUL
zarih?	LAGAB×SUM
zarx(KAK)	KAK
zax(NISAG)	NISAG
zax(ZU)	ZU
zax(|GU%GU|)	GU%GU
zax(|U.ŠA|)	U.ŠA
zax(|UD.NI|)	UD.NI
zax(|ZAx|)	ZAx
zax(ŠEŠ)	ŠEŠ
zaz	BAD
zazana	TUR&TUR.ZA&ZA
zazanax(|TUR&TUR.ZA&ZA.TUR&TUR.ZA&ZA|)	TUR&TUR.ZA&ZA.TUR&TUR.ZA&ZA
zazna	TUR&TUR.ZA&ZA
zaznax(|TUR&TUR.ZA&ZA.TUR&TUR.ZA&ZA|)	TUR&TUR.ZA&ZA.TUR&TUR.ZA&ZA
zaĝ3	NISAG
zaĝa	NI
zaĝx(|UD×U+U+U@g|)	UD×U+U+U@g
ze	ZI
ze2	ZE2
ze4	AB×ŠEŠ
zeb3	GUD
zeh2	ŠUBUR
zel	NUN
zenax?(HA@t@g)	HA@t@g
zer3	MUŠ
zermušku	IGI@g.TAK4.ALAN
zermuškux(|TAK4.ALAN|)	TAK4.ALAN
zermuššu	IGI@g.TAK4.ALAN
zerx(TUR)	TUR
zezna	TUR&TUR.ZA&ZA
zeznax(|TUR&TUR.ZA&ZA.TUR&TUR.ZA&ZA|)	TUR&TUR.ZA&ZA.TUR&TUR.ZA&ZA
zi	ZI
zi...	NUN@t.ŠE
zi2	ZE2
zi3	ZI3
zi4	AB×ŠEŠ
zi7	KI.NE
zi8?	KAL
zib	AŠ@z&AŠ@z&AŠ@z&AŠ@z
zib2	ZIG
zib3	GUD
zib4?	KA
zibar	UD.KA.BAR
zibar3	KA×UD.BAR
zibin	DAG.KISIM5×TAK4
zibin2	DAG.KISIM5×U2+GIR2
zid	ZI
zid2	ZI3
zig	ZIG
zig2	SIG
zig3	ZI
zigara	IM%IM
zigkaru	IM%IM
zigx(|PA.GI|)	PA.GI
zih	GU%GU
zih2	ŠUBUR
zik	ZIG
zik2	SIG
zik3	URU×MIN
zikara	IM%IM
zikaru	IM%IM
zikum	LAGAB×HAL
zikumux(|LAGAB×HAL|)	LAGAB×HAL
zikumx(|EŠ2.UD|)	EŠ2.UD
zikumx(|LAGAB×A|)	LAGAB×A
zikura	KASKAL.6(DIŠ)
zil	NUN
zil2	TAG
zil3	TAR
zililix(|PA.URU×MIN|)	PA.URU×MIN
zilpe	NUN@t.KI
zilulu	PA.URU×MIN
zimbir	UD.GIŠ%GIŠ.NUN
zin	ŠEN
zinanutu	HI×AŠ
zip	AŠ@z&AŠ@z&AŠ@z&AŠ@z
zip3	PA.LU
zipah	MAŠ
zipah2	ŠU.BAD
zipahx(|ŠU2.BAD|)	ŠU2.BAD
ziq	ZIG
ziq2	SIG
ziqi	ZIG
zir	KUL
zir2	EŠ2.KA
zir3	MUŠ
zir4	SUD
ziri	KUL
zirmuššu?	IGI@g.TAK4.ALAN
zirru	EN.NUNUZ.ZI.AN.ŠEŠ.KI
zirrux(|EN.SAL.ME.NUNUZ.ZI.AN.ŠEŠ.KI|)	EN.SAL.ME.NUNUZ.ZI.AN.ŠEŠ.KI
zis	BAD
zix(IGI@g)	IGI@g
zix(NE)	NE
ziz	BAD
ziz2	ZIZ2
ziz3	HI×AŠ
ziz4	GIŠ×BAD
ziz5	TAG.TAG
zizanu	KUR
zizna	TUR&TUR.ZA&ZA
ziznax(|TUR&TUR.ZA&ZA.TUR&TUR.ZA&ZA|)	TUR&TUR.ZA&ZA.TUR&TUR.ZA&ZA
zizx(|TUR&TUR.ZA&ZA|)	TUR&TUR.ZA&ZA
zu	ZU
zu2	KA
zu3	ZUM
zu4	BAD
zu5	ZU5
zu6	SUD
zu7	DUN
zu8	PAP.NA2
zu9	KA×UD
zub	KAM4
zub2	AŠ@z&AŠ@z&AŠ@z&AŠ@z
zubi	KAM4
zubu	KAM4
zubud	HA@t
zubur	ZUBUR
zuen	EN.ZU
zuena	EN.ZU
zug	LAGAB×A
zug2	KA
zug3	SAG×U2
zug4	KA×LI
zugud	HA@t
zuguz?	KA×LUM
zugx(|LAGAB×GAR|)	LAGAB×GAR
zuh	KA
zuhx(|KA×LI|)	KA×LI
zuk	LAGAB×A
zukum	ZI&ZI.LAGAB
zukumx(|A.ZI&ZI|)	A.ZI&ZI
zukumx(|ZI&ZI.A|)	ZI&ZI.A
zukumx(|ZI&ZI.EŠ2|)	ZI&ZI.EŠ2
zukura	KA×TAR
zukurax(|KA×X|)	KA×X
zulug	LUL
zuluhu	SIK2.SUD
zuluhu2	SIK2.BU
zuluhu3	ZI&ZI.LAGAB
zuluhu4	LAGAB×A.LUM
zulumhi	SIK2.SUD
zulumhi2	SIK2.BU
zulumhi3	ZI&ZI.LAGAB
zum	ZUM
zum2	SAL.LAGAB×AŠ2
zuq	LAGAB×A
zur	AMAR
zur2	SUR9
zur3	MA2.IGI@g
zur4	LAGAB×SUM
zur5	LAL
zur8	ŠA
zuru10	BAD.AŠ
zuru5	LAL
zuru9	BAD
zurzub	DUG
zurzub2	KAL
zusu	SUD2
zux(AŠ)	AŠ
zux(ZI3)	ZI3
ālik	DU@s
ĝa10	A
ĝa2	GA2
ĝa3?	GAN2
ĝa6	IL2
ĝaburra	GA2×BUR+RA
ĝaburrax(|GA2×BUR|)	GA2×BUR
ĝagia	GA2×GI4
ĝagiax(|GA2×GI4+A|)	GA2×GI4+A
ĝahalla	GA2×HAL+LA
ĝahallax(|GA2×HAL|)	GA2×HAL
ĝahili	GA2×HI+LI
ĝaiku	GA2×AŠ
ĝal2	IG
ĝal4	SAL
ĝalga	GA2×GAR
ĝalgax(|E2×GAR|)	E2×GAR
ĝalilla	GA2×KID+LAL
ĝalillax(|GA2×KID|)	GA2×KID
ĝanun	GA2×NUN
ĝar	GAR
ĝar3	GAR3
ĝar7	MAR
ĝar8	SIG4
ĝarim	LAGAB×KU3
ĝarim2	DAG.KISIM5×AMAR
ĝarin	LAGAB×KU3
ĝarza	PA.AN
ĝarza2	PA.LUGAL
ĝarzu	PA.AN
ĝasag?	GA2×KU3+AN
ĝasibir	GA2×EN×GAN2@t
ĝasikilla	GA2×EL+LA
ĝasikillax(|GA2×EL|)	GA2×EL
ĝaĝirsu	GA2×GIR2+SU
ĝe26	GA2
ĝe6	MI
ĝe7	EŠ2
ĝedar	PA
ĝedru	PA
ĝeli3	KA×LI
ĝen	DU
ĝer15	EŠ2
ĝereš2	GURUŠ
ĝestug	PI
ĝezzalx(|GIŠ.TUG2.PI.ŠIR@t.SILA3|)	GIŠ.TUG2.PI.ŠIR@t.SILA3
ĝeš	GIŠ
ĝeš2	DIŠ
ĝeš3	UŠ
ĝešba	RU
ĝešbax(|ŠU.PAP.PAP|)	ŠU.PAP.PAP
ĝešbu	RU
ĝešbu2	ŠU.PAP.PAP
ĝešbun	KI.BI.GAR
ĝešbun2	KI.BI
ĝešbux?(|GIŠ.RU|)	GIŠ.RU
ĝešdu	PI
ĝešimmar	ŠA6
ĝešmaš	AL×GIŠ
ĝešnimbar	ŠA6
ĝešnu	NU11
ĝešnu2?	NU11.IR
ĝešnux(|GIŠ.NU11|)	GIŠ.NU11
ĝešnux(|NU11.GIŠ|)	NU11.GIŠ
ĝešpax?(|GIŠ.RU|)	GIŠ.RU
ĝešpu	RU
ĝešpu2	ŠU.PAP.PAP
ĝešpux?(|GIŠ.RU|)	GIŠ.RU
ĝeštae	ZA×4×KUR
ĝeštin	GEŠTIN
ĝeština	GEŠTIN
ĝeštu	PI
ĝeštu2	GIŠ.TUG2.PI
ĝeštu3	GIŠ.PI.TUG2
ĝeštug	PI
ĝeštug2	GIŠ.TUG2.PI
ĝeštug3	GIŠ.PI.TUG2
ĝešturu	PA
ĝeštux(|PI.GIŠ.TUG2|)	PI.GIŠ.TUG2
ĝeššir	EN×GAN2@t
ĝi25	DUGUD
ĝi6	MI
ĝi7	EŠ2
ĝidlam	SAL.UŠ.DAM
ĝidlam2	UŠ.DAM
ĝidlam3	UŠ.SAL.DAM
ĝidlam4	SAL.UŠ
ĝidri	PA
ĝidru	PA
ĝili3	KA×LI
ĝim6	DU
ĝin	DU
ĝir	HA@g
ĝir15	EŠ2
ĝir2	GIR2
ĝir3	GIR3
ĝiri	HA@g
ĝiri16	GIR3×GAN2@t
ĝiri2	GIR2
ĝiri3	GIR3
ĝirix(|KA×LI|)	KA×LI
ĝiskim	IGI.DUB
ĝissu	GIŠ.MI
ĝistug	PI
ĝitlam	SAL.UŠ.DAM
ĝitlam2	UŠ.DAM
ĝitlam3	UŠ.SAL.DAM
ĝizzal	GIŠ.TUG2.PI.ŠIR.SILA3
ĝizzal2	ŠIR@t.SILA3
ĝizzalx(GIŠ)	GIŠ
ĝizzalx(|GIŠ.TUG2.PI.ŠIR@t.SILA3|)	GIŠ.TUG2.PI.ŠIR@t.SILA3
ĝiš	GIŠ
ĝiš2	DIŠ
ĝiš3	UŠ
ĝišbun	KI.BI.GAR
ĝišbun2	KI.BI
ĝišbunx(KI)	KI
ĝišdu	PI
ĝišgal	URU×MIN
ĝišimmar	ŠA6
ĝiškim	IGI.DUB
ĝišnimbar	ŠA6
ĝišnu2?	NU11.IR
ĝišnux(|NU11.GIŠ|)	NU11.GIŠ
ĝištu	PI
ĝištu2	GIŠ.TUG2.PI
ĝištu3	GIŠ.PI.TUG2
ĝištug	PI
ĝištug2	GIŠ.TUG2.PI
ĝištug3	GIŠ.PI.TUG2
ĝiššir	EN×GAN2@t
ĝu10	MU
ĝuruš	GURUŠ
ĝušur	GA2×NUN&NUN
ĝušur2	RAB.GAL
ĝušurx(|RAB.MAH|)	RAB.MAH
ĝušurx(|RAB.TUR.TUR|)	RAB.TUR.TUR
ĪNU	IGI.MIN
īnu	IGI.MIN
ŚA	SA
ŚA2	DI
ŚAR	SAR
ŚE	SI
ŚE2	SIG
ŚI	SI
ŚI2	SI@g
ŚI3	SIG
ŚIM2	NAM
ŚU	SU
ŚU2	SI@g
ŚU3	SUD
ŚUM	TAG
ŚUM2	SUM
ŚUR	SUR
ŚUR2	SAG@g
śa	SA
śa2	DI
śar	SAR
śe	SI
śe2	SIG
śi	SI
śi2	SI@g
śi3	SIG
śim2	NAM
śu	SU
śu2	SI@g
śu3	SUD
śum	TAG
śum2	SUM
śur	SUR
śur2	SAG@g
şa	ZA
şa3	AN
şab	ERIN2
şah	NE
şah2	KID
şak	ZAG
şal	NI
şalmu	SAG@g
şap	ERIN2
şapa	ERIN2
şar	LAGAB×SUM
şar2	AMAR
şara	LAGAB×SUM
şe	ZE2
şe2	ZI
şeh	ŠUBUR
şeh2	NE
şi	ZE2
şi2	ZI
şi3	SI
şi9	EŠ2
şib	AŠ@z&AŠ@z&AŠ@z&AŠ@z
şib2	ZIG
şibi	AŠ@z&AŠ@z&AŠ@z&AŠ@z
şil	NUN
şil2	MI
şil3	AN.SAG@g
şil4	GIŠ.MI
şillu	AN.SAG@g
şim	ZUM
şin	U.U.U
şip	AŠ@z&AŠ@z&AŠ@z&AŠ@z
şir	MUŠ
şiş	BAD
şu	ZUM
şu2	ZU
şum	ZUM
şur	AMAR
şur2	MUŠ
şuru	AMAR
şurşub	DUG
şurşub2	KAL
şābu	ERIN2
şītu	UD
ša	ŠA
ša10	SA
ša11	LU2
ša12	SAL
ša13	GA2
ša15?	IGI.ERIN2
ša16	EŠ2
ša17	IGI.DIB
ša2	GAR
ša21	BI
ša22	HU.NA2
ša23	BARA2
ša24	SAG
ša3	ŠA3
ša4	DU
ša5	AK
ša6	ŠA6
ša7?	RI
ša8	SAR
ša9	GUM
šab	PA.IB
šab2	ŠA3
šab4	ME
šab5	PA.LU
šab6	ŠAB6
šaba	PA.IB
šabalbal	KUL
šabra	PA.AL
šabra2	PA.E2
šabu	ŠE.NUN&NUN
šabux(|GIŠ×TAK4|)	GIŠ×TAK4
šad	KUR
šad2?	MU
šada	KUR
šadu	KUR
šag	SAG
šag3	PA
šag4	ŠA3
šag5	ŠA6
šag6?	SIG
šaga	LU2×GAN2@t
šagan	U.GAN
šaganx(|GA2×AN|)	GA2×AN
šagar	KA×GAR
šagax(LU2)	LU2
šaggin	GIR3.ARAD
šaggina	GIR3.ARAD
šagginx(|ANŠE.ARAD|)	ANŠE.ARAD
šagia	SILA3.ŠU.GABA
šagina	GIR3.ARAD
šagx(|AB2.ŠA3|)	AB2.ŠA3
šagx(|AB2×TAK4|)	AB2×TAK4
šagx(|AB2×ŠA3|)	AB2×ŠA3
šagx(|U.KID|)	U.KID
šah	ŠUBUR
šah2	DUN
šah3	KID
šaha	ŠUBUR
šahab	ŠU.DIŠ
šahab2	ŠU.DI.U.U.U
šahan	KUR
šahan2?	MUŠ
šahan3	DUN
šak	SAG
šak6?	SIG
šak7	TUR
šakaka	KI.LAM
šakan	U.GAN
šakan2	GIR3
šakan3	ANŠE
šakan4	ANŠE.AN
šakan5	NUNUZ.AB2×AŠGAB
šakan6	GIR3.ARAD
šakanka	KI.LAM
šakanx(|ANŠE.PA|)	ANŠE.PA
šakar	SAR
šakir	URU×GU
šakir3	URU×GA
šakira	URU×GU
šakira2	KI.AN.UD
šakira3	URU×GA
šakirax(|URU×MIN+NI+GA|)	URU×MIN+NI+GA
šakiri	URU×GU
šakirx(|KI.AN.UD|)	KI.AN.UD
šakirx(|URU×MIN+NI+GA|)	URU×MIN+NI+GA
šakkan2	GIR3
šakkan6	ANŠE.ARAD
šakkan7	GA2×AN
šakx(|U.KID|)	U.KID
šal	SAL
šal2	SILA3
šal3	NI
šalam2	NUN.LAGAR×MAŠ
šalambi	ŠA3
šalambix(|ŠA3.GIŠ.SAR|)	ŠA3.GIŠ.SAR
šallam	NUN.LAGAR×SAL
šallam2	NUN.LAGAR×MAŠ
šallur	GIŠ%GIŠ
šam	U2
šam2	NINDA2×ŠE
šam3	NINDA2×AN
šam4	NAM
šamagx(IGI@g)	IGI@g
šaman+	EŠ2.SUD.NUN.EŠ2.TU
šaman2	U.GAN
šamanur	URUDA.IŠ.URUDA
šamanur+	EŠ2.SUD.NUN.EŠ2.TU
šamaš	UD
šamaš2	U.U
šammi	U2
šamnu	NI
šamx(|NINDA2×ŠE+A+AN|)	NINDA2×ŠE+A+AN
šamx(|NINDA2×ŠE+A.AN|)	NINDA2×ŠE+A.AN
šamx(|NINDA2×ŠE+A|)	NINDA2×ŠE+A
šamx(|NINDA2×ŠE.A.AN|)	NINDA2×ŠE.A.AN
šamx(|NINDA2×ŠE.A|)	NINDA2×ŠE.A
šan	NINDA2×AN
šan2	TAG
šanaba	ŠANABI
šanabi	ŠANABI
šanapi	ŠANABI
šandan	GAL.NI
šandana	GAL.NI
šandilimma	KU7
šanga	ŠID
šanga7	PA.ŠA6
šanna	GAN2.BU
šantag	DIŠ
šantak	DIŠ
šap	PA.IB
šap5	PA.LU
šap6	ŠAB6
šapra	PA.AL
šapra2	PA.E2
šaq	SAG
šaqa	BI.LUL
šaqa2	ŠIM×LUL
šaqu	BI.LUL
šaqu2	ŠIM×LUL
šaqu3?	GUM
šaqum	BI.LUL
šar	SAR
šar2	ŠAR2
šar3	LUGAL
šar4	U.U
šar5	IM
šar6	BARA2
šar7	TAR
šar8	NI
šara	BARA2
šara2	LAGAB×IGI@g
šara3	LAGAB×TAK4
šara4	LAGAB×GUD
šara5	IM
šara6	ŠAR2
šara7	SAR
šarag	UD
šaragx(|UD.SAR|)	UD.SAR
šaran	DAG.KISIM5×BALAG
šaran2	DAG.KISIM5×U2+GIR2
šarap	KAL.EDIN
šarax(LUGAL)	LUGAL
šarax(|UD.SAR|)	UD.SAR
šardiš?	HI×DIŠ
šargad	HI×GAD
šargadu	HI×GAD
šargaldiš	ŠAR2×GAL+DIŠ
šargalmin	ŠAR2×GAL+MIN
šargeš?	HI×DIŠ
šarin	DAG.KISIM5×U2+GIR2
šarra	LUGAL
šarru	LUGAL
šarru2	U.U
šaru	HI×U
šarx(NE)	NE
šas	ŠEŠ
šasuk	SAG.DUN3
šat	KUR
šata	KUR
šatam	LUL
šattam	LUL
šax(|ŠA3×ŠU2|)	ŠA3×ŠU2
šaĝa	LU2×GAN2@t
šaĝan	U.GAN
šaĝar	KA×GAR
šaĝax(LU2)	LU2
šaş	ŠEŠ
šaš	ŠEŠ
šaški	BU
šašku	BU
šaţ	KUR
šaţam	LUL
še	ŠE
še10	KU
še11	LUL
še12	A.MUŠ3
še13	DU
še14	ŠID
še15	ŠE.NUN&NUN
še16	ŠEŠ
še17	MUŠ3.DI
še18	A.MUŠ3.DI
še19	SUM
še2	SI
še20	IGI
še21	HU.NA2
še22	EREN
še23	MUŠ3
še24	MUŠ3@g
še25	KA×ŠID
še26	KA×BALAG
še27	SIG4
še28	KA
še29	LU2×GAN2@t
še3	EŠ2
še3-munu4	EŠ2.PAP.PAP
še4	MUŠ3×A+DI
še5	ZA.MUŠ3.DI
še6	NE
še7	A.AN
še8	ŠEŠ2
še9	ŠU2.AN
šeb4	SIG4
šed	ŠID
šed10	MUŠ3.DI
šed12	MUŠ3
šed13	MUŠ3@g
šed14	KA×ŠID
šed15	KA×BALAG
šed16	SIG4
šed17?	KA
šed3	NUN%NUN
šed4	KAD3
šed5	KAD4
šed6	KU
šed7	MUŠ3×A+DI
šed8	ZA.MUŠ3.DI
šed9	A.MUŠ3
šedu	KAL
šedu2	UDUG
šedu3	A×LAGAR@g
šedur	LAGAB×TE+A+SU+NA
šedx(LAK171@s)	LAK171@s
šedx(|KA×ŠU|)	KA×ŠU
šedx(|MUŠ3×A|)	MUŠ3×A
šeg10	KA×ŠID
šeg11	KA×BALAG
šeg12	SIG4
šeg13?	KA
šeg14	IM.A.AN
šeg3	A.AN
šeg4	A.ŠU2.NAGA
šeg5	URU×TU
šeg6	NE
šeg8	ŠU2.NAGA
šeg9	ŠEG9
šeg9-bar	ŠEG9
šega9	ŠEG9
šegga	ŠEG9
šegx(A)	A
šegx(HA@g)	HA@g
šegx(SAG)	SAG
šegx(|GIŠ.NE@s|)	GIŠ.NE@s
šegx(|IM.A.A|)	IM.A.A
šegx(|IM.A|)	IM.A
šegx(|KA×KID2|)	KA×KID2
šegx(|KA×LI|)	KA×LI
šegx(|KA×ŠU|)	KA×ŠU
šegx(|URU×GU|)	URU×GU
šegx(|URU×ŠE|)	URU×ŠE
šeknux(|URUDA.IŠ.URUDA|)	URUDA.IŠ.URUDA
šel4	SAL
šem	ŠIM
šem3	AB2×ŠA3
šem4	AB2×ME+EN
šem5	AB2×GAN2@t
šem6	AB2×TAK4
šembi	ŠIM×IGI@g
šembi2	ŠIM
šembi3	BI×IGI@g
šembirida	U2.KUR.RA
šembizi	ŠIM
šembulug3	ŠIM×IGI
šembulug4	ŠIM×BAL
šembulug5	ŠIM×BULUG
šembulug?	BULUG&BULUG
šembulugx(|ŠIM.BAL|)	ŠIM.BAL
šembulugx(ŠIM)	ŠIM
šembulugx(ŠIM×KUŠU2)	ŠIM×KUŠU2
šemešal	ŠIM×SAL
šemmišla	ŠIM×SAL
šemmug	ŠIM×BULUG
šemuš	ŠE.ŠEŠ
šemx(NE)	NE
šemx(|A.AN|)	A.AN
šemx(|AB2.ŠA3|)	AB2.ŠA3
šemšala	ŠIM×SAL
šen	ŠEN
šen2	URUDA
šen3	NAM
šen4	DUB
šenbar?	ŠEG9
šendilima	KU7
šennu	EN.ME.AD.KU3
šennur	GIŠ%GIŠ
šenx(ŠEG9)	ŠEG9
šer	ŠIR
šer10	MUŠ
šer11	GIR3.BAR
šer2	BU
šer3	EZEN
šer4	UZU
šer7	NUN&NUN
šer9	SAR
šerah	MUŠ
šerax(|TAG.TUG2|)	TAG.TUG2
šerba	LAGAB×GUD+GUD
šerid	TAG
šerim	TAG
šerim2	LAGAB×SUM
šerimsur	LAGAB×ŠE+SUM
šerimx(|TAG.TUG2|)	TAG.TUG2
šerinsur	LAGAB×ŠE+SUM
šerkan	IM.DUB2
šerrida	UD.AN.UD
šeru	UZU
šes	ŠEŠ
šesag	ŠE.LUGAL
šex(IGI@g)	IGI@g
šex(NA2)	NA2
šex(SIG)	SIG
šex(|A.MUŠ3×A.DI|)	A.MUŠ3×A.DI
šex(|A.MUŠ|)	A.MUŠ
šex(|GIŠ×TAK4|)	GIŠ×TAK4
šex(|IGI×A|)	IGI×A
šex(|KA×ŠU|)	KA×ŠU
šex(|MUŠ3×A|)	MUŠ3×A
šex(|MUŠ3×DI|)	MUŠ3×DI
šex(|MUŠ×A|)	MUŠ×A
šex(|MUŠ×ZA|)	MUŠ×ZA
šeĝ	SIG
šeĝ3	A.AN
šeĝ6	NE
šeĝ7	IM
šeš	ŠEŠ
šeš2	ŠEŠ2
šeš3	A×IGI
šeš4	EREN
šešlam	ŠEŠLAM
šešlam2	EN.ME.LI
šešx(|A.IGI|)	A.IGI
šeššed	NUN%NUN
šeššed2	KAD3.KAD3
šeššed3	KAD4.KAD4.KAD5
šeššeg	URU×TU.URU×TU
ši	IGI
ši2	SI
ši3	SIG
ši4	EŠ2
ši5	KU
ši6	ŠIM
ši7	IGI@g
šib	ME
šib2	RU
šib3	PA.IB
šib4	AŠ@z&AŠ@z&AŠ@z&AŠ@z
šibir	U.EN×GAN2@t
šibir2?	EN×GAN2@t
šid	ŠID
šid2?	KAD2
šid3	NUN%NUN
šidax(SUD2)	SUD2
šidi	DIM2
šidim	DIM2
šidimgalx(|GAL.DIM2|)	GAL.DIM2
šidx(KA×BALAG)	KA×BALAG
šidx(|KA×BALAG|)	KA×BALAG
šig	SIG
šig5	URU×TU
šigagu	AŠGAB
šigx(KA×BALAG)	KA×BALAG
šigx(KA×ŠID)	KA×ŠID
šigx(URU)	URU
šigx(|KA×BALAG|)	KA×BALAG
šigx(|KA×ŠID|)	KA×ŠID
šigx(|URU×GU|)	URU×GU
šigx(|URU×ŠE|)	URU×ŠE
ših	ŠUBUR
ših2	KID
šik	SIG
šik2	SIK2
šika	LA
šikahara	SIG4&SIG4.ŠU2
šikangu	AŠGAB
šikin	GAR
šikin2	DUG
šikin3	SIK2.LAM
šikira3	URU×GA
šikx(LA)	LA
šil	TAR
šil3	U
šilam	NUN.LAGAR×SAL
šilam2	NUN.LAGAR×MAŠ
šilamx(DIM2)	DIM2
šilamx?(|NUN.LAGAR|)	NUN.LAGAR
šilax(|NUN.LAGAR×SAL|)	NUN.LAGAR×SAL
šilig	URU×IGI
šilig5	URU×URUDA
šilig6	KA×ŠID
šilig7	KA×IGI
šim	ŠIM
šim2	NAM
šimaški	LU.SU
šimaški2	LU.SU.A
šimbi	ŠIM×IGI@g
šimbi3	BI×IGI@g
šimbirida	U2.KUR.RA
šimbizi	ŠIM
šimbulug2?	ŠIM×MUG
šimbulug3	ŠIM×IGI
šimbulug5	ŠIM×BULUG
šimbulug?	BULUG&BULUG
šimešal	ŠIM×SAL
šimeššal	ŠIM×SAL
šimmešla	ŠIM×SAL
šimmug	ŠIM×BULUG
šin	ŠEN
šin2?	MIN
šina	MIN
šindilib	KU7
šindilimma	KU7
šinig	ŠINIG
šinx(|ŠIM×GAR|)	ŠIM×GAR
šip	ME
šip3	PA.IB
šiq	SIG
šiq2	SIK2
šiq4	KA×ŠID
šir	ŠIR
šir10	MUŠ
šir2	BU
šir3	EZEN
šir4	UZU
šir5	NU
šir6	TUR
šir8	SUD
šir9	SAR
širam	UZU
širi	KA×X
širim	UZU
širu	UZU
širum	UZU
širx(|MA×TAK4|)	MA×TAK4
šit	ŠID
šita	ŠITA
šita2	ŠITA2
šita3	SUD2
šita4	U.KID
šita5	ŠID
šitalamx(DIM2)	DIM2
šitanx(SUD2)	SUD2
šitax(|KAK.GIŠ|)	KAK.GIŠ
šiten	KI.DU.KAK
šitenx(|KI.LUGAL|)	KI.LUGAL
šiti	ŠID
šitim	DIM2
šitim2	ŠID
šix(KA)	KA
šix(KA×BALAG)	KA×BALAG
šix(|KA×BALAG|)	KA×BALAG
šix(|KA×ŠU|)	KA×ŠU
šiz	ŠEŠ
šizbu	GA
šiş	ŠEŠ
šiš	ŠEŠ
šiš2	ŠEŠ2
šiţ	ŠID
šu	ŠU
šu-gi	ŠU.GI
šu-u	ŠU.U
šu10	MU
šu11	SU
šu12	KA×ŠU
šu13	BI
šu14	TAG
šu15?	ZUM
šu16	U.UD
šu2	ŠU2
šu3	EŠ2
šu4	U
šu5	LAGAB×ŠU2
šu6	LAGAB×ŠU2+ŠU2
šu7?	GAR
šub	RU
šub3	PA.IB
šub4	MUNSUB
šub5	ZI&ZI.LAGAB
šub6	ŠID
šub7	ZA.MUŠ3@g
šub8	ZA.MUŠ3
šuba	ZA.MUŠ3@g
šuba2	ZA.MUŠ3
šuba3	MUŠ3.ZA
šuba4?	MUŠ3
šuba5	RU
šubar	ŠUBUR
šubartin	ŠU2
šubax(MUŠ)	MUŠ
šubax(|MUŠ.ŠA|)	MUŠ.ŠA
šubax(|ZA.AN.MUŠ3@g|)	ZA.AN.MUŠ3@g
šubax?(|U2.ZA.MUŠ3|)	U2.ZA.MUŠ3
šubba	EZEN×X
šubtu	KASKAL.LAGAB
šubtu3	KASKAL.LAGAB
šubtu4	KASKAL&KASKAL.LAGAB&LAGAB
šubtu5	KASKAL.LAGAB×U
šubtu6	KASKAL.LAGAB×U&LAGAB×U
šubtu7	(KASKAL.LAGAB×U)&(KASKAL.LAGAB×U)
šubtum3	KASKAL.LAGAB
šubtum4	KASKAL&KASKAL.LAGAB&LAGAB
šubtum5	KASKAL.LAGAB×U
šubtum6	KASKAL.LAGAB×U&LAGAB×U
šubtum7	(KASKAL.LAGAB×U)&(KASKAL.LAGAB×U)
šubtumx(KASKAL)	KASKAL
šubul	AN
šubun	KI.BI.GAR
šubur	ŠUBUR
šubur2?	ARAD
šubura	ŠUBUR
šubux(|U2.ZA.MUŠ3|)	U2.ZA.MUŠ3
šubux(|ZA.MUŠ3|)	ZA.MUŠ3
šubx(|A.ZI&ZI|)	A.ZI&ZI
šubx(|KA×GA|)	KA×GA
šubx(|ZI&ZI.A|)	ZI&ZI.A
šubx(|ZI&ZI.EŠ2|)	ZI&ZI.EŠ2
šud	SUD
šud2	BU
šud3	KA×ŠU
šud4	ŠID
šudaminx?(ŠANABI)	ŠANABI
šudax?(ŠUŠANA)	ŠUŠANA
šude3	KA×ŠU
šudu3	KA×ŠU
šudug	GI.PAD
šudul	ŠU2.DUN3@g@g@s
šudun	ŠU2.DUN3@g@g@s
šudul2	U.TUG2
šudul3	ŠU2.UR@s
šudul4	UR@s
šudul5	UR@s
šudul6	U.KID
šudum	ŠID
šudun2	U.TUG2
šudun3	ŠU2.UR@s
šudun4	DUN4
šudun5	UR@s
šudx(KA)	KA
šudx(|KA.ŠU|)	KA.ŠU
šug	PAD
šugi	ŠU.GI%GI
šugmaš?	ŠU.KAL
šugur	LUGAL
šuh	MUŠ3@g
šuh2	ŠUBUR
šuhub	ŠU2.ANx3
šuhub2	ANx3
šuhub4	ŠU.DI.U.U.U
šuhubx(|AN.ANx3|)	AN.ANx3
šuhuš	DU@g
šuk	PAD
šuk2	MUG
šuk3	LAGAB×A
šukal	LUH
šukbar?	ŠU.KAL
šukkal	LUH
šukra	ŠU.GAN2@t
šuku	PAD
šukudx(|ŠU.HA|)	ŠU.HA
šukumx(|LAGAB×KUL|)	LAGAB×KUL
šukun3	PAD
šukur	IGI.KAK
šukur2	PAD
šukx(MUŠ3@g)	MUŠ3@g
šul	DUN
šul3	DI
šullat	IDIM
šullat2	PA
šum	TAG
šum2	SUM
šum3	MU
šum4	TIL
šum5	BUR2
šumati	MU.ME.U.U.U
šumgamme	TAG.GAM.ME
šumu	MU
šumu2	SUM
šumu3	TAG
šumugx(UM)	UM
šumun	TIL
šumunda	LAGAR@g&LAGAR@g.ŠE.SAR
šun	ŠEN
šun2	ANx3
šun3	GUL
šun4	SUM
šunigin	ŠU.GAN2@t
šup	RU
šup2	AŠ
šup3	PA.IB
šuq	PAD
šuqux(|ŠIM×LUL|)	ŠIM×LUL
šur	SUR
šur2	SAG@g
šur3	ŠIR
šur4	LAL2.SAR
šur5	LAL.LAGAB
šur6?	LAL2.LAGAB
šurim	LAGAB×GUD+GUD
šurim3	LAGAB×GUD
šurimx(|SIK2.AŠ|)	SIK2.AŠ
šurin4	DAG.KISIM5×NE
šurin5	DAG.KISIM5×U2+GIR2
šuripak	SU.KUR.RU
šuripak2	LAM×KUR+RU
šurippak	SU.KUR.RU
šurippak2	LAM×KUR+RU
šurmen	ŠU.ME.EREN
šurmenx(|EREN.ŠU.ME|)	EREN.ŠU.ME
šurmenx(|ŠU.EREN.ME|)	ŠU.EREN.ME
šurmin	ŠU.ME.EREN
šuru	LAGAB×GUD+GUD
šuru2	LAGAB×TAK4
šuru3	LAGAB×GUD
šuru6	TAK4
šurum	LAGAB×GUD+GUD
šurum3	LAGAB×GUD
šurum6	TAK4
šurumx(|NUN.LAGAR|)	NUN.LAGAR
šurumx(|SIK2.AŠ|)	SIK2.AŠ
šurumx(|URU×GU|)	URU×GU
šurun	LAGAB×GUD+GUD
šurun2	LAGAB×TAK4
šurun3	LAGAB×GUD
šurun4	DAG.KISIM5×NE
šurun5?	DAG.KISIM5×U2+GIR2
šurunx(|SIK2.AŠ|)	SIK2.AŠ
šurupak	SU.KUR.RU
šurupak2	LAM×KUR+RU
šuruppak	SU.KUR.RU
šuruppak2	LAM×KUR+RU
šuruppakx(|SU.RU×KUR|)	SU.RU×KUR
šurux(E)	E
šurux(LAL)	LAL
šurux(|E.SUD.HUB2×UD|)	E.SUD.HUB2×UD
šurux(|E.TUM|)	E.TUM
šurux(|SIK2.AŠ|)	SIK2.AŠ
šurx(LAL)	LAL
šusbu	MUŠ3@g
šut	SUD
šutug	PAD
šutug2	HI×NUN.ME
šutul3	ŠU2.UR@s
šutul4	DUN4
šutul5	UR@s
šutul6	U.KID
šutulx(|U.UR@s|)	U.UR@s
šutum	GI.NA.AB.U.GUD
šutum2	E2.GI.NA.AB.U.GUD
šutumx(|E2.GI.NA.AB.HI|)	E2.GI.NA.AB.HI
šutumx(|GI.NA.AB.NA.TUM|)	GI.NA.AB.NA.TUM
šutumx(|KI.NA.AB.TUM|)	KI.NA.AB.TUM
šutumx(|MI.NA.AB.U.GUD|)	MI.NA.AB.U.GUD
šutun4	DUN4
šutun5	UR@s
šutur	MAH
šuwati	MU.ME.U.U.U
šux(RU)	RU
šux(SUD)	SUD
šux(TAK4)	TAK4
šux(|DU&DU.DU&DU|)	DU&DU.DU&DU
šux(|DU.DU.DU.DU|)	DU.DU.DU.DU
šux(|DU.DU|)	DU.DU
šux(|DU@s.DU@s|)	DU@s.DU@s
šux(|IM.ŠU2|)	IM.ŠU2
šuz	SUD
šuzi	UR
šuš	U
šuš2	ŠU2
šuš3	IŠ
šuš4	TAG
šuš5	LAGAB×ŠU2
šuš6	LAGAB×ŠU2+ŠU2
šušana	ŠUŠANA
šušana2	U.U
šušanaku	U.U
šušbar	AL×UŠ
šušgim	GUD
šušin	MUŠ3.EREN
šušinak	MUŠ3.EREN
šušinakx(MUŠ3@g)	MUŠ3@g
šušmaš	AL×UŠ
šušu	SUD2
šušum	MUŠ3.EREN
šušur	AŠ&AŠ&AŠ
šušur2	AŠ&AŠ&AŠ%AŠ&AŠ&AŠ
šušux(|MUŠ3@g.SIK2.LAM|)	MUŠ3@g.SIK2.LAM
šušux(|ZA.MUŠ3@g.EREN|)	ZA.MUŠ3@g.EREN
šuššanx(ŠUŠANA)	ŠUŠANA
šuššub	PAP.PAP.IDIM×4
šuţ	SUD
šēdu	UDUG
ţa	DA
ţa2	TA
ţa3	HI
ţa4	DAM
ţab	TAB
ţab3	DIB
ţab6	HI
ţah	MU&MU
ţah2	GABA
ţak?	DAG
ţal	RI
ţam	DAM
ţam2	UD
ţan	KAL
ţap	TAB
ţar	TAR
ţar2	DAR
ţar3	DARA3
ţat	TAK4
ţe	DI
ţe2	HI
ţe3	NE
ţe4	TE
ţe5	UMUM×KASKAL
ţe6	TI
ţi	DI
ţi2	HI
ţi3	TI
ţi4	TE
ţi5	NE
ţib	DIB
ţil	AŠ
ţil2	BAD
ţim	DIM
ţim2	DIM2
ţin?	DIN
ţip	DIB
ţir	SI.A
ţir2	TAR
ţir3	SUR
ţir4	DAR
ţir5	ŠE.NUN&NUN
ţiš	DIŠ
ţu	DUN3
ţu2	TU
ţu3	DU
ţu4	TUM
ţu5	GABA
ţub2	DUB2
ţuh	GABA
ţul	LAGAB×U
ţul3	LAGAR@g
ţum	TUM
ţup	DUB
ţur	GU2×KAK
ţur2	DUR2
ţur3	TUR
ţur4	GIŠ%GIŠ
ţur5	A
ţēmu	KA.HI
